35
35
4
200 -1 200 -1 200 -1 200 -1 200 -1 200 -1 200 -1 200 -1 200 -1 200 -1 200 -1 200 -1 200 -1 200 -1 200 -1 200 -1 200 -1 229 -1 231 -1 205 -1 225 -1 200 -1 200 -1 200 -1 200 -1 200 -1 200 -1 200 -1 200 -1 200 -1 200 -1 200 -1 200 -1 200 -1 200 -1 
200 -1 200 -1 200 -1 200 -1 200 -1 200 -1 200 -1 200 -1 200 -1 200 -1 200 -1 200 -1 200 -1 200 -1 200 -1 200 -1 200 -1 204 -1 3 -1 3 -1 202 -1 200 -1 200 -1 200 -1 200 -1 200 -1 200 -1 200 -1 200 -1 200 -1 200 -1 200 -1 200 -1 200 -1 200 -1 
200 -1 200 -1 200 -1 200 -1 200 -1 200 -1 200 -1 200 -1 200 -1 200 -1 200 -1 311 -1 302 -1 302 -1 302 -1 308 -1 200 -1 204 -1 3 -1 216 -1 231 -1 316 -1 302 -1 308 -1 200 -1 311 -1 320 -1 205 -1 205 -1 205 -1 225 -1 200 -1 200 -1 200 -1 200 -1 
200 -1 200 -1 200 -1 200 -1 200 -1 200 -1 200 -1 200 -1 200 -1 200 -1 200 -1 301 -1 3 -1 3 -1 3 -1 306 -1 320 -1 212 -1 3 -1 3 -1 401 0 3 -1 3 -1 306 -1 302 -1 307 -1 3 -1 3 -1 3 -1 3 -1 202 -1 200 -1 200 -1 200 -1 200 -1 
200 -1 200 -1 200 -1 200 -1 200 -1 200 -1 200 -1 200 -1 200 -1 200 -1 200 -1 301 -1 401 -1 3 -1 3 -1 3 -1 3 -1 3 -1 3 -1 3 -1 3 -1 3 -1 3 -1 3 -1 3 -1 3 -1 3 -1 3 -1 3 -1 216 -1 231 -1 205 -1 225 -1 200 -1 200 -1 
200 -1 200 -1 200 -1 200 -1 200 -1 200 -1 200 -1 200 -1 200 -1 200 -1 200 -1 310 -1 305 -1 3 -1 2 -1 2 -1 2 -1 402 0 3 -1 3 -1 3 -1 3 -1 2 -1 2 -1 3 -1 3 -1 2 -1 2 -1 2 -1 3 -1 3 -1 3 -1 313 -1 200 -1 200 -1 
200 -1 200 -1 200 -1 200 -1 200 -1 200 -1 200 -1 200 -1 200 -1 200 -1 200 -1 200 -1 301 -1 2 -1 2 -1 2 -1 3 -1 3 -1 3 -1 3 -1 400 0 3 -1 2 -1 2 -1 2 -1 2 -1 2 -1 401 -1 3 -1 3 -1 3 -1 3 -1 202 -1 200 -1 200 -1 
200 -1 200 -1 200 -1 200 -1 200 -1 200 -1 200 -1 200 -1 200 -1 200 -1 224 -1 316 -1 307 -1 3 -1 2 -1 3 -1 3 -1 3 -1 3 -1 3 -1 3 -1 3 -1 3 -1 401 0 3 -1 2 -1 3 -1 3 -1 3 -1 3 -1 210 -1 314 -1 223 -1 200 -1 200 -1 
200 -1 200 -1 200 -1 200 -1 200 -1 200 -1 200 -1 200 -1 200 -1 224 -1 212 -1 3 -1 3 -1 3 -1 3 -1 3 -1 3 -1 401 0 3 -1 3 -1 3 -1 3 -1 402 0 3 -1 3 -1 2 -1 3 -1 3 -1 3 -1 210 -1 223 -1 200 -1 200 -1 200 -1 200 -1 
200 -1 200 -1 200 -1 200 -1 200 -1 200 -1 200 -1 311 -1 320 -1 212 -1 3 -1 3 -1 3 -1 3 -1 3 -1 3 -1 2 -1 2 -1 2 -1 2 -1 3 -1 3 -1 3 -1 304 -1 305 -1 3 -1 3 -1 210 -1 314 -1 223 -1 200 -1 200 -1 200 -1 200 -1 200 -1 
200 -1 200 -1 200 -1 200 -1 200 -1 200 -1 311 -1 307 -1 3 -1 3 -1 3 -1 3 -1 3 -1 402 -1 3 -1 2 -1 2 -1 2 -1 2 -1 2 -1 2 -1 3 -1 3 -1 303 -1 310 -1 300 -1 318 -1 223 -1 200 -1 200 -1 200 -1 200 -1 200 -1 200 -1 200 -1 
200 -1 200 -1 200 -1 200 -1 311 -1 324 -1 307 -1 3 -1 3 -1 3 -1 3 -1 3 -1 3 -1 3 -1 2 -1 3 -1 3 -1 2 -1 2 -1 2 -1 2 -1 401 0 3 -1 306 -1 308 -1 200 -1 200 -1 200 -1 200 -1 200 -1 200 -1 200 -1 200 -1 200 -1 200 -1 
200 -1 200 -1 200 -1 311 -1 307 -1 3 -1 3 -1 3 -1 3 -1 3 -1 3 -1 3 -1 3 -1 3 -1 3 -1 3 -1 3 -1 2 -1 2 -1 3 -1 3 -1 3 -1 3 -1 3 -1 306 -1 308 -1 200 -1 200 -1 200 -1 200 -1 200 -1 200 -1 200 -1 200 -1 200 -1 
200 -1 200 -1 311 -1 307 -1 3 -1 401 -1 3 -1 2 -1 2 -1 2 -1 3 -1 3 -1 3 -1 3 -1 401 -1 3 -1 3 -1 3 -1 3 -1 3 -1 3 -1 3 -1 3 -1 3 -1 304 -1 309 -1 200 -1 200 -1 200 -1 200 -1 200 -1 200 -1 200 -1 200 -1 200 -1 
200 -1 200 -1 319 -1 401 1 3 -1 2 -1 2 -1 2 -1 3 -1 3 -1 3 -1 3 -1 4 -1 4 -1 4 -1 4 -1 4 -1 3 -1 3 -1 3 -1 3 -1 3 -1 401 -1 3 -1 321 -1 200 -1 200 -1 200 -1 311 -1 302 -1 308 -1 200 -1 200 -1 200 -1 200 -1 
200 -1 200 -1 204 -1 3 -1 2 -1 2 -1 2 -1 3 -1 3 -1 401 1 4 -1 4 -1 4 -1 4 -1 4 -1 4 -1 109 -1 103 -1 103 -1 103 -1 103 -1 1 -1 103 -1 103 -1 200 -1 200 -1 200 -1 200 -1 310 -1 300 -1 309 -1 200 -1 200 -1 200 -1 200 -1 
200 -1 200 -1 204 -1 3 -1 3 -1 2 -1 2 -1 402 1 3 -1 4 -1 4 -1 4 -1 4 -1 4 -1 4 -1 3 -1 105 -1 4 -1 4 -1 4 -1 401 -1 3 -1 3 -1 3 -1 214 -1 205 -1 225 -1 200 -1 200 -1 200 -1 200 -1 200 -1 200 -1 200 -1 200 -1 
200 -1 200 -1 229 -1 219 -1 3 -1 3 -1 3 -1 3 -1 4 -1 4 -1 4 -1 210 -1 203 -1 203 -1 203 -1 203 -1 242 -1 4 -1 4 -1 4 -1 4 -1 2 -1 3 -1 3 -1 3 -1 3 -1 202 -1 200 -1 200 -1 200 -1 200 -1 200 -1 200 -1 200 -1 200 -1 
200 -1 200 -1 204 -1 3 -1 3 -1 400 1 3 -1 3 -1 4 -1 4 -1 216 -1 227 -1 200 -1 200 -1 200 -1 200 -1 222 -1 239 -1 219 -1 4 -1 4 -1 4 -1 3 -1 3 -1 216 -1 206 -1 227 -1 200 -1 200 -1 200 -1 200 -1 200 -1 200 -1 200 -1 200 -1 
200 -1 224 -1 230 -1 209 -1 3 -1 3 -1 3 -1 3 -1 4 -1 4 -1 4 -1 202 -1 200 -1 200 -1 200 -1 200 -1 224 -1 212 -1 4 -1 4 -1 4 -1 3 -1 2 -1 3 -1 3 -1 3 -1 214 -1 316 -1 308 -1 200 -1 200 -1 200 -1 200 -1 200 -1 200 -1 
200 -1 222 -1 239 -1 213 -1 3 -1 3 -1 3 -1 401 1 4 -1 4 -1 4 -1 202 -1 200 -1 200 -1 200 -1 200 -1 204 -1 4 -1 4 -1 4 -1 401 3 3 -1 2 -1 2 -1 2 -1 2 -1 401 -1 3 -1 306 -1 302 -1 308 -1 200 -1 200 -1 200 -1 200 -1 
200 -1 200 -1 315 -1 3 -1 402 1 3 -1 3 -1 3 -1 2 -1 4 -1 4 -1 214 -1 225 -1 200 -1 200 -1 224 -1 212 -1 4 -1 4 -1 4 -1 3 -1 3 -1 3 -1 2 -1 2 -1 2 -1 2 -1 3 -1 2 -1 2 -1 303 -1 200 -1 200 -1 200 -1 200 -1 
200 -1 200 -1 315 -1 3 -1 3 -1 2 -1 2 -1 2 -1 2 -1 2 -1 4 -1 4 -1 214 -1 205 -1 205 -1 212 -1 4 -1 4 -1 4 -1 2 -1 2 -1 3 -1 3 -1 3 -1 3 -1 3 -1 3 -1 402 3 3 -1 2 -1 303 -1 200 -1 200 -1 200 -1 200 -1 
200 -1 224 -1 212 -1 3 -1 2 -1 2 -1 2 -1 2 -1 2 -1 401 -1 4 -1 4 -1 4 -1 4 -1 4 -1 4 -1 4 -1 4 -1 3 -1 2 -1 2 -1 2 -1 2 -1 2 -1 2 -1 3 -1 3 -1 3 -1 401 3 304 -1 309 -1 200 -1 200 -1 200 -1 200 -1 
200 -1 323 -1 401 1 3 -1 3 -1 3 -1 2 -1 2 -1 2 -1 2 -1 2 -1 4 -1 4 -1 4 -1 4 -1 4 -1 4 -1 401 -1 3 -1 2 -1 401 3 2 -1 2 -1 2 -1 3 -1 3 -1 3 -1 3 -1 3 -1 303 -1 200 -1 200 -1 200 -1 200 -1 200 -1 
200 -1 310 -1 305 -1 3 -1 304 -1 305 -1 3 -1 3 -1 2 -1 2 -1 3 -1 401 2 3 -1 3 -1 402 2 401 2 3 -1 3 -1 3 -1 2 -1 2 -1 2 -1 2 -1 2 -1 2 -1 400 3 3 -1 3 -1 3 -1 303 -1 200 -1 200 -1 200 -1 200 -1 200 -1 
200 -1 200 -1 310 -1 305 -1 306 -1 307 -1 3 -1 2 -1 402 -1 2 -1 2 -1 2 -1 3 -1 2 -1 2 -1 3 -1 2 -1 2 -1 2 -1 2 -1 2 -1 2 -1 2 -1 3 -1 2 -1 3 -1 3 -1 3 -1 3 -1 321 -1 200 -1 200 -1 200 -1 200 -1 200 -1 
200 -1 200 -1 200 -1 301 -1 3 -1 3 -1 3 -1 2 -1 2 -1 3 -1 3 -1 2 -1 2 -1 2 -1 2 -1 2 -1 2 -1 3 -1 2 -1 402 -1 2 -1 2 -1 3 -1 2 -1 2 -1 3 -1 3 -1 3 -1 210 -1 223 -1 200 -1 200 -1 200 -1 200 -1 200 -1 
200 -1 200 -1 200 -1 310 -1 305 -1 3 -1 3 -1 3 -1 2 -1 3 -1 2 -1 2 -1 2 -1 2 -1 2 -1 2 -1 2 -1 2 -1 2 -1 3 -1 3 -1 3 -1 3 -1 401 -1 3 -1 402 3 3 -1 210 -1 223 -1 200 -1 200 -1 200 -1 200 -1 200 -1 200 -1 
200 -1 200 -1 200 -1 200 -1 319 -1 401 -1 3 -1 3 -1 3 -1 2 -1 2 -1 2 -1 2 -1 400 2 3 -1 3 -1 3 -1 3 -1 3 -1 3 -1 3 -1 3 -1 3 -1 3 -1 401 3 3 -1 3 -1 313 -1 200 -1 200 -1 200 -1 200 -1 200 -1 200 -1 200 -1 
200 -1 200 -1 200 -1 200 -1 204 -1 3 -1 218 -1 3 -1 2 -1 2 -1 2 -1 2 -1 2 -1 3 -1 3 -1 3 -1 3 -1 401 2 3 -1 3 -1 3 -1 3 -1 3 -1 3 -1 3 -1 3 -1 210 -1 223 -1 200 -1 200 -1 200 -1 200 -1 200 -1 200 -1 200 -1 
200 -1 200 -1 200 -1 200 -1 222 -1 203 -1 242 -1 401 2 3 -1 3 -1 3 -1 3 -1 402 2 3 -1 3 -1 3 -1 3 -1 3 -1 401 -1 3 -1 3 -1 3 -1 3 -1 3 -1 218 -1 3 -1 202 -1 200 -1 200 -1 200 -1 200 -1 200 -1 200 -1 200 -1 200 -1 
200 -1 200 -1 200 -1 200 -1 200 -1 200 -1 222 -1 208 -1 3 -1 3 -1 3 -1 3 -1 210 -1 203 -1 208 -1 3 -1 3 -1 3 -1 3 -1 3 -1 3 -1 210 -1 322 -1 318 -1 228 -1 314 -1 223 -1 200 -1 200 -1 200 -1 200 -1 200 -1 200 -1 200 -1 200 -1 
200 -1 200 -1 200 -1 200 -1 200 -1 200 -1 200 -1 222 -1 203 -1 203 -1 203 -1 203 -1 223 -1 200 -1 222 -1 322 -1 300 -1 300 -1 326 -1 300 -1 318 -1 223 -1 200 -1 200 -1 200 -1 200 -1 200 -1 200 -1 200 -1 200 -1 200 -1 200 -1 200 -1 200 -1 200 -1 
200 -1 200 -1 200 -1 200 -1 200 -1 200 -1 200 -1 200 -1 200 -1 200 -1 200 -1 200 -1 200 -1 200 -1 200 -1 200 -1 200 -1 200 -1 200 -1 200 -1 200 -1 200 -1 200 -1 200 -1 200 -1 200 -1 200 -1 200 -1 200 -1 200 -1 200 -1 200 -1 200 -1 200 -1 200 -1 
-1
