20
20
4
3 -1 3 -1 402 0 3 -1 401 0 3 -1 3 -1 401 0 4 -1 4 -1 4 -1 4 -1 401 1 3 -1 3 -1 401 1 3 -1 402 1 3 -1 3 -1 
3 -1 400 0 3 -1 3 -1 3 -1 3 -1 3 -1 3 -1 4 -1 4 -1 4 -1 4 -1 3 -1 3 -1 3 -1 3 -1 3 -1 3 -1 400 1 3 -1 
402 0 3 -1 3 -1 403 0 3 -1 3 -1 3 -1 3 -1 401 0 4 -1 4 -1 401 1 3 -1 3 -1 3 -1 3 -1 403 1 3 -1 3 -1 402 1 
3 -1 3 -1 403 0 3 -1 3 -1 3 -1 2 -1 3 -1 3 -1 4 -1 4 -1 3 -1 3 -1 2 -1 3 -1 3 -1 3 -1 403 1 3 -1 3 -1 
401 0 3 -1 3 -1 3 -1 3 -1 2 -1 2 -1 3 -1 3 -1 4 -1 4 -1 3 -1 3 -1 2 -1 2 -1 3 -1 3 -1 3 -1 3 -1 401 1 
3 -1 3 -1 3 -1 3 -1 2 -1 2 -1 3 -1 3 -1 3 -1 4 -1 4 -1 3 -1 3 -1 3 -1 2 -1 2 -1 3 -1 3 -1 3 -1 3 -1 
3 -1 3 -1 3 -1 2 -1 2 -1 3 -1 3 -1 3 -1 401 -1 4 -1 4 -1 401 -1 3 -1 3 -1 3 -1 2 -1 2 -1 3 -1 3 -1 3 -1 
401 0 3 -1 3 -1 3 -1 3 -1 3 -1 3 -1 402 -1 401 -1 4 -1 4 -1 401 -1 402 -1 3 -1 3 -1 3 -1 3 -1 3 -1 3 -1 401 1 
4 -1 4 -1 401 0 3 -1 3 -1 3 -1 401 -1 401 -1 4 -1 4 -1 4 -1 4 -1 401 -1 401 -1 3 -1 3 -1 3 -1 401 1 4 -1 4 -1 
4 -1 4 -1 4 -1 4 -1 4 -1 4 -1 4 -1 4 -1 4 -1 401 -1 403 -1 4 -1 4 -1 4 -1 4 -1 4 -1 4 -1 4 -1 4 -1 4 -1 
4 -1 4 -1 4 -1 4 -1 4 -1 4 -1 4 -1 4 -1 4 -1 403 -1 401 -1 4 -1 4 -1 4 -1 4 -1 4 -1 4 -1 4 -1 4 -1 4 -1 
4 -1 4 -1 401 3 3 -1 3 -1 3 -1 401 -1 401 -1 4 -1 4 -1 4 -1 4 -1 401 -1 401 -1 3 -1 3 -1 3 -1 401 2 4 -1 4 -1 
401 3 3 -1 3 -1 3 -1 3 -1 3 -1 3 -1 402 -1 401 -1 4 -1 4 -1 401 -1 402 -1 3 -1 3 -1 3 -1 3 -1 3 -1 3 -1 401 2 
3 -1 3 -1 3 -1 2 -1 2 -1 3 -1 3 -1 3 -1 401 -1 4 -1 4 -1 401 -1 3 -1 3 -1 3 -1 2 -1 2 -1 3 -1 3 -1 3 -1 
3 -1 3 -1 3 -1 3 -1 2 -1 2 -1 3 -1 3 -1 3 -1 4 -1 4 -1 3 -1 3 -1 3 -1 2 -1 2 -1 3 -1 3 -1 3 -1 3 -1 
401 3 3 -1 3 -1 3 -1 3 -1 2 -1 2 -1 3 -1 3 -1 4 -1 4 -1 3 -1 3 -1 2 -1 2 -1 3 -1 3 -1 3 -1 3 -1 401 2 
3 -1 3 -1 403 3 3 -1 3 -1 3 -1 2 -1 3 -1 3 -1 4 -1 4 -1 3 -1 3 -1 2 -1 3 -1 3 -1 3 -1 403 2 3 -1 3 -1 
402 3 3 -1 3 -1 403 3 3 -1 3 -1 3 -1 3 -1 401 3 4 -1 4 -1 401 2 3 -1 3 -1 3 -1 3 -1 403 2 3 -1 3 -1 402 2 
3 -1 400 3 3 -1 3 -1 3 -1 3 -1 3 -1 3 -1 4 -1 4 -1 4 -1 4 -1 3 -1 3 -1 3 -1 3 -1 3 -1 3 -1 400 2 3 -1 
3 -1 3 -1 402 3 3 -1 401 3 3 -1 3 -1 401 3 4 -1 4 -1 4 -1 4 -1 401 2 3 -1 3 -1 401 2 3 -1 402 2 3 -1 3 -1 
-1
