50
50
2
4 -1 4 -1 4 -1 3 -1 3 -1 3 -1 3 -1 3 -1 3 -1 3 -1 2 -1 2 -1 3 -1 3 -1 3 -1 3 -1 3 -1 2 -1 2 -1 3 -1 3 -1 3 -1 3 -1 4 -1 4 -1 3 -1 3 -1 3 -1 3 -1 3 -1 3 -1 3 -1 3 -1 4 -1 3 -1 3 -1 2 -1 2 -1 2 -1 3 -1 3 -1 3 -1 2 -1 3 -1 3 -1 3 -1 2 -1 2 -1 2 -1 2 -1 
3 -1 4 -1 4 -1 4 -1 4 -1 3 -1 3 -1 3 -1 3 -1 3 -1 3 -1 3 -1 2 -1 3 -1 3 -1 3 -1 3 -1 3 -1 2 -1 3 -1 3 -1 3 -1 3 -1 4 -1 4 -1 3 -1 401 -1 3 -1 403 -1 3 -1 401 -1 3 -1 4 -1 4 -1 3 -1 3 -1 3 -1 3 -1 3 -1 3 -1 2 -1 3 -1 2 -1 3 -1 3 -1 2 -1 3 -1 3 -1 3 -1 3 -1 
3 -1 3 -1 3 -1 401 -1 3 -1 3 -1 3 -1 3 -1 3 -1 2 -1 3 -1 2 -1 3 -1 3 -1 2 -1 2 -1 3 -1 3 -1 3 -1 3 -1 3 -1 3 -1 3 -1 3 -1 4 -1 4 -1 3 -1 3 -1 3 -1 3 -1 3 -1 3 -1 4 -1 4 -1 3 -1 3 -1 3 -1 3 -1 3 -1 3 -1 3 -1 3 -1 3 -1 3 -1 3 -1 3 -1 2 -1 2 -1 3 -1 3 -1 
3 -1 3 -1 3 -1 3 -1 4 -1 4 -1 3 -1 3 -1 2 -1 3 -1 2 -1 3 -1 3 -1 3 -1 3 -1 3 -1 2 -1 2 -1 3 -1 3 -1 3 -1 3 -1 3 -1 3 -1 3 -1 3 -1 3 -1 4 -1 4 -1 4 -1 4 -1 3 -1 3 -1 3 -1 2 -1 2 -1 3 -1 3 -1 4 -1 4 -1 4 -1 4 -1 4 -1 3 -1 3 -1 3 -1 3 -1 2 -1 2 -1 2 -1 
3 -1 402 -1 3 -1 4 -1 4 -1 3 -1 3 -1 3 -1 2 -1 3 -1 2 -1 2 -1 2 -1 2 -1 2 -1 3 -1 3 -1 2 -1 2 -1 3 -1 3 -1 3 -1 3 -1 3 -1 3 -1 3 -1 3 -1 4 -1 4 -1 4 -1 3 -1 3 -1 3 -1 3 -1 2 -1 3 -1 3 -1 3 -1 3 -1 4 -1 4 -1 4 -1 4 -1 4 -1 3 -1 3 -1 3 -1 3 -1 3 -1 3 -1 
3 -1 3 -1 3 -1 4 -1 4 -1 3 -1 3 -1 3 -1 3 -1 2 -1 3 -1 3 -1 3 -1 3 -1 3 -1 3 -1 3 -1 3 -1 3 -1 3 -1 3 -1 3 -1 2 -1 3 -1 3 -1 3 -1 3 -1 3 -1 3 -1 3 -1 3 -1 3 -1 3 -1 2 -1 3 -1 3 -1 3 -1 4 -1 3 -1 4 -1 4 -1 3 -1 3 -1 4 -1 3 -1 3 -1 3 -1 3 -1 3 -1 3 -1 
3 -1 401 -1 3 -1 4 -1 3 -1 2 -1 3 -1 3 -1 3 -1 3 -1 3 -1 3 -1 3 -1 3 -1 4 -1 4 -1 4 -1 4 -1 3 -1 4 -1 3 -1 3 -1 3 -1 3 -1 2 -1 2 -1 3 -1 3 -1 3 -1 3 -1 2 -1 3 -1 3 -1 3 -1 3 -1 3 -1 4 -1 4 -1 3 -1 401 -1 3 -1 3 -1 3 -1 3 -1 401 -1 3 -1 4 -1 3 -1 3 -1 3 -1 
4 -1 4 -1 3 -1 3 -1 3 -1 3 -1 2 -1 3 -1 2 -1 3 -1 3 -1 3 -1 4 -1 3 -1 4 -1 4 -1 4 -1 3 -1 3 -1 4 -1 4 -1 4 -1 3 -1 3 -1 3 -1 3 -1 2 -1 2 -1 2 -1 3 -1 3 -1 3 -1 3 -1 3 -1 3 -1 3 -1 4 -1 4 -1 4 -1 3 -1 3 -1 3 -1 3 -1 3 -1 3 -1 4 -1 4 -1 3 -1 2 -1 2 -1 
3 -1 3 -1 3 -1 3 -1 3 -1 3 -1 3 -1 2 -1 2 -1 3 -1 3 -1 3 -1 4 -1 3 -1 4 -1 3 -1 3 -1 3 -1 3 -1 3 -1 4 -1 4 -1 4 -1 3 -1 2 -1 2 -1 3 -1 3 -1 3 -1 3 -1 3 -1 3 -1 2 -1 2 -1 2 -1 3 -1 4 -1 4 -1 4 -1 3 -1 3 -1 402 -1 3 -1 3 -1 4 -1 4 -1 3 -1 3 -1 2 -1 3 -1 
3 -1 3 -1 3 -1 3 -1 3 -1 3 -1 3 -1 2 -1 3 -1 3 -1 3 -1 3 -1 4 -1 4 -1 4 -1 3 -1 3 -1 3 -1 402 -1 3 -1 3 -1 4 -1 4 -1 3 -1 2 -1 3 -1 3 -1 3 -1 3 -1 3 -1 3 -1 3 -1 3 -1 3 -1 3 -1 3 -1 4 -1 3 -1 3 -1 3 -1 3 -1 3 -1 3 -1 3 -1 4 -1 4 -1 3 -1 3 -1 3 -1 3 -1 
3 -1 3 -1 3 -1 3 -1 3 -1 3 -1 3 -1 2 -1 3 -1 3 -1 3 -1 3 -1 4 -1 4 -1 3 -1 3 -1 3 -1 3 -1 3 -1 3 -1 401 -1 4 -1 4 -1 3 -1 3 -1 3 -1 3 -1 4 -1 4 -1 4 -1 3 -1 3 -1 3 -1 3 -1 3 -1 2 -1 3 -1 3 -1 4 -1 4 -1 3 -1 3 -1 3 -1 3 -1 4 -1 3 -1 3 -1 3 -1 2 -1 3 -1 
3 -1 3 -1 3 -1 2 -1 3 -1 3 -1 3 -1 3 -1 3 -1 3 -1 3 -1 3 -1 3 -1 3 -1 3 -1 3 -1 3 -1 3 -1 3 -1 3 -1 3 -1 3 -1 3 -1 3 -1 3 -1 3 -1 4 -1 3 -1 3 -1 3 -1 3 -1 4 -1 4 -1 3 -1 3 -1 3 -1 3 -1 3 -1 3 -1 4 -1 4 -1 4 -1 4 -1 3 -1 4 -1 3 -1 3 -1 3 -1 3 -1 3 -1 
3 -1 3 -1 3 -1 2 -1 3 -1 3 -1 2 -1 3 -1 3 -1 3 -1 3 -1 3 -1 3 -1 4 -1 3 -1 3 -1 3 -1 3 -1 401 -1 3 -1 4 -1 4 -1 3 -1 3 -1 4 -1 4 -1 3 -1 3 -1 3 -1 3 -1 3 -1 4 -1 4 -1 4 -1 3 -1 3 -1 2 -1 2 -1 3 -1 3 -1 4 -1 4 -1 4 -1 3 -1 3 -1 3 -1 3 -1 3 -1 3 -1 3 -1 
3 -1 3 -1 3 -1 3 -1 3 -1 3 -1 3 -1 3 -1 3 -1 2 -1 2 -1 3 -1 3 -1 3 -1 4 -1 4 -1 4 -1 4 -1 3 -1 3 -1 4 -1 3 -1 3 -1 3 -1 4 -1 4 -1 4 -1 3 -1 3 -1 3 -1 3 -1 3 -1 4 -1 4 -1 4 -1 3 -1 3 -1 3 -1 3 -1 3 -1 3 -1 3 -1 3 -1 3 -1 3 -1 3 -1 3 -1 2 -1 2 -1 3 -1 
3 -1 2 -1 2 -1 3 -1 2 -1 3 -1 3 -1 2 -1 3 -1 2 -1 3 -1 3 -1 3 -1 3 -1 3 -1 3 -1 4 -1 4 -1 4 -1 4 -1 4 -1 3 -1 3 -1 3 -1 4 -1 4 -1 3 -1 401 -1 3 -1 3 -1 3 -1 401 -1 3 -1 4 -1 4 -1 3 -1 3 -1 2 -1 2 -1 2 -1 3 -1 3 -1 3 -1 2 -1 3 -1 3 -1 3 -1 2 -1 2 -1 3 -1 
3 -1 3 -1 2 -1 3 -1 2 -1 2 -1 2 -1 3 -1 3 -1 3 -1 3 -1 3 -1 3 -1 3 -1 3 -1 3 -1 3 -1 3 -1 3 -1 3 -1 3 -1 3 -1 3 -1 3 -1 4 -1 4 -1 4 -1 3 -1 3 -1 3 -1 402 -1 3 -1 3 -1 4 -1 4 -1 3 -1 3 -1 3 -1 2 -1 3 -1 3 -1 3 -1 3 -1 3 -1 2 -1 2 -1 3 -1 3 -1 3 -1 3 -1 
2 -1 3 -1 3 -1 2 -1 3 -1 3 -1 3 -1 3 -1 3 -1 3 -1 3 -1 2 -1 3 -1 2 -1 3 -1 3 -1 2 -1 2 -1 3 -1 2 -1 3 -1 3 -1 2 -1 3 -1 3 -1 3 -1 4 -1 3 -1 3 -1 3 -1 4 -1 4 -1 3 -1 3 -1 3 -1 3 -1 3 -1 3 -1 3 -1 3 -1 3 -1 3 -1 3 -1 3 -1 3 -1 3 -1 2 -1 3 -1 3 -1 2 -1 
2 -1 2 -1 3 -1 2 -1 2 -1 2 -1 2 -1 2 -1 2 -1 3 -1 2 -1 2 -1 3 -1 2 -1 2 -1 3 -1 2 -1 2 -1 3 -1 3 -1 3 -1 2 -1 2 -1 3 -1 3 -1 3 -1 3 -1 3 -1 4 -1 4 -1 4 -1 3 -1 2 -1 2 -1 2 -1 2 -1 3 -1 3 -1 3 -1 3 -1 3 -1 3 -1 3 -1 3 -1 3 -1 3 -1 3 -1 3 -1 3 -1 2 -1 
2 -1 3 -1 3 -1 3 -1 3 -1 3 -1 3 -1 3 -1 3 -1 3 -1 2 -1 3 -1 3 -1 2 -1 3 -1 3 -1 2 -1 3 -1 3 -1 3 -1 3 -1 3 -1 3 -1 3 -1 3 -1 3 -1 3 -1 3 -1 3 -1 3 -1 3 -1 3 -1 3 -1 3 -1 2 -1 3 -1 3 -1 401 1 3 -1 3 -1 3 -1 3 -1 3 -1 3 -1 3 1 3 -1 3 -1 3 -1 3 -1 2 -1 
2 -1 3 -1 3 -1 3 -1 3 -1 3 -1 3 -1 3 -1 3 -1 3 -1 3 -1 2 -1 3 -1 3 -1 3 -1 3 -1 3 -1 3 -1 3 -1 3 -1 3 -1 3 -1 3 -1 3 -1 3 -1 3 -1 3 -1 3 -1 3 -1 3 -1 3 -1 2 -1 2 -1 3 -1 3 -1 3 -1 3 -1 3 -1 3 -1 3 -1 3 -1 3 -1 3 -1 3 -1 3 -1 3 -1 3 -1 3 -1 3 -1 3 -1 
2 -1 3 -1 3 -1 2 -1 3 -1 3 -1 3 -1 2 -1 3 -1 3 -1 3 -1 3 -1 3 -1 3 -1 2 -1 3 -1 3 -1 3 -1 3 -1 3 -1 4 -1 4 -1 3 -1 4 -1 4 -1 3 -1 3 -1 3 -1 3 -1 3 -1 3 -1 3 -1 3 -1 2 -1 3 -1 3 -1 3 -1 3 -1 3 -1 3 -1 3 -1 3 -1 3 -1 401 1 3 -1 3 -1 3 -1 3 -1 3 -1 3 -1 
3 -1 3 -1 2 -1 2 -1 3 -1 3 -1 3 -1 3 -1 3 -1 3 -1 3 -1 3 -1 3 -1 3 -1 3 -1 3 -1 3 -1 3 -1 3 -1 4 -1 4 -1 4 -1 4 -1 3 -1 3 -1 4 -1 4 -1 3 -1 3 -1 3 -1 3 -1 2 -1 2 -1 2 -1 3 -1 3 -1 3 -1 3 -1 402 1 3 -1 400 1 3 -1 3 -1 3 -1 3 -1 3 -1 3 -1 3 -1 3 -1 3 -1 
3 -1 3 -1 3 -1 3 -1 3 -1 3 -1 3 0 3 -1 3 -1 3 -1 3 -1 3 -1 3 -1 3 -1 3 -1 3 -1 3 -1 3 -1 3 -1 3 -1 3 -1 3 -1 3 -1 3 -1 3 -1 3 -1 4 -1 4 -1 3 -1 3 -1 3 -1 3 -1 2 -1 3 -1 3 -1 3 -1 3 -1 3 -1 3 -1 3 -1 3 -1 3 -1 3 -1 3 -1 3 -1 3 -1 3 -1 3 -1 3 -1 3 -1 
2 -1 3 -1 3 -1 3 -1 3 -1 3 -1 3 -1 3 -1 3 -1 3 -1 3 0 3 -1 3 -1 3 -1 3 -1 3 -1 3 -1 3 -1 3 -1 4 -1 3 -1 3 -1 3 -1 3 -1 3 -1 3 -1 3 -1 3 -1 3 -1 3 -1 3 -1 3 -1 3 -1 2 -1 3 -1 3 -1 3 1 3 -1 3 -1 3 -1 3 -1 3 -1 3 -1 3 -1 3 1 3 -1 3 -1 3 -1 3 -1 3 -1 
2 -1 2 -1 2 -1 3 -1 3 -1 3 -1 3 -1 3 -1 3 -1 3 -1 3 -1 3 -1 3 -1 3 -1 3 -1 3 -1 3 -1 3 -1 3 -1 4 -1 3 -1 3 -1 3 -1 3 -1 3 -1 402 -1 401 -1 4 -1 3 -1 3 -1 3 -1 3 -1 3 -1 3 -1 3 -1 3 -1 3 -1 3 -1 3 -1 3 -1 3 -1 3 -1 3 -1 3 -1 3 -1 3 -1 3 -1 3 -1 2 -1 3 -1 
2 -1 3 -1 3 -1 2 -1 3 -1 3 -1 3 -1 3 -1 3 -1 3 -1 3 -1 3 -1 3 -1 3 0 3 -1 3 -1 3 -1 3 -1 4 -1 4 -1 3 -1 3 -1 3 -1 3 -1 3 -1 3 -1 3 -1 4 -1 3 -1 3 -1 3 -1 3 -1 3 -1 3 -1 3 -1 3 -1 3 -1 3 -1 3 -1 3 -1 2 -1 3 -1 3 -1 3 -1 3 -1 3 -1 3 -1 3 -1 2 -1 3 -1 
3 -1 3 -1 3 -1 3 -1 3 -1 3 -1 3 -1 3 -1 3 -1 400 0 3 -1 3 -1 3 -1 3 -1 3 -1 3 -1 3 -1 3 -1 3 -1 4 -1 3 -1 3 -1 3 -1 401 -1 3 -1 4 -1 4 -1 3 -1 3 -1 3 -1 3 -1 3 -1 3 -1 3 -1 3 -1 3 -1 2 -1 3 -1 3 -1 3 -1 3 -1 2 -1 3 -1 3 -1 2 -1 3 -1 3 -1 3 -1 3 -1 3 -1 
3 -1 3 -1 3 -1 3 -1 3 -1 3 -1 401 0 3 -1 3 -1 3 -1 3 -1 3 -1 3 -1 3 -1 3 -1 3 -1 3 -1 3 -1 3 -1 3 -1 4 -1 4 -1 3 -1 4 -1 4 -1 4 -1 3 -1 3 -1 3 -1 3 -1 3 -1 3 -1 3 -1 2 -1 3 -1 3 -1 3 -1 3 -1 3 -1 3 -1 3 -1 3 -1 3 -1 3 -1 3 -1 3 -1 3 -1 3 -1 2 -1 3 -1 
3 -1 2 -1 3 -1 3 -1 3 -1 3 -1 401 0 3 -1 3 -1 3 -1 402 0 3 -1 3 -1 3 -1 3 -1 3 -1 3 -1 3 -1 3 -1 3 -1 3 -1 3 -1 3 -1 3 -1 3 -1 3 -1 3 -1 3 -1 3 -1 3 -1 3 -1 3 -1 3 -1 3 -1 2 -1 3 -1 3 -1 2 -1 2 -1 3 -1 3 -1 3 -1 2 -1 3 -1 3 -1 3 -1 2 -1 2 -1 3 -1 3 -1 
3 -1 3 -1 3 -1 3 -1 3 -1 3 -1 3 -1 3 -1 3 -1 3 -1 3 -1 3 -1 3 -1 3 -1 3 -1 3 -1 3 -1 3 -1 3 -1 3 -1 3 -1 3 -1 3 -1 3 -1 3 -1 3 -1 3 -1 3 -1 3 -1 3 -1 3 -1 2 -1 3 -1 3 -1 2 -1 3 -1 2 -1 2 -1 3 -1 3 -1 3 -1 3 -1 2 -1 3 -1 3 -1 3 -1 3 -1 3 -1 3 -1 3 -1 
3 -1 2 -1 3 -1 3 -1 3 -1 3 -1 3 -1 3 -1 3 -1 3 -1 3 -1 3 -1 3 -1 3 -1 3 -1 3 -1 3 -1 3 -1 3 -1 3 -1 3 -1 3 -1 3 -1 3 -1 3 -1 4 -1 3 -1 3 -1 3 -1 3 -1 3 -1 2 -1 3 -1 3 -1 3 -1 3 -1 3 -1 3 -1 3 -1 3 -1 2 -1 3 -1 3 -1 2 -1 3 -1 3 -1 3 -1 2 -1 3 -1 3 -1 
2 -1 3 -1 3 -1 3 -1 3 -1 3 -1 3 -1 3 -1 3 -1 3 -1 3 -1 3 -1 3 -1 3 -1 2 -1 2 -1 2 -1 3 -1 3 -1 3 -1 3 -1 3 -1 3 -1 4 -1 4 -1 4 -1 4 -1 3 -1 3 -1 3 -1 3 -1 3 -1 3 -1 3 -1 2 -1 2 -1 2 -1 2 -1 3 -1 3 -1 2 -1 3 -1 3 -1 3 -1 3 -1 2 -1 3 -1 2 -1 3 -1 3 -1 
2 -1 3 -1 3 -1 3 -1 3 -1 4 -1 4 -1 4 -1 4 -1 4 -1 4 -1 3 -1 3 -1 3 -1 3 -1 3 -1 3 -1 3 -1 3 -1 3 -1 3 -1 4 -1 4 -1 4 -1 3 -1 3 -1 3 -1 4 -1 3 -1 3 -1 3 -1 3 -1 3 -1 3 -1 3 -1 2 -1 3 -1 3 -1 3 -1 3 -1 3 -1 2 -1 3 -1 3 -1 3 -1 3 -1 3 -1 2 -1 2 -1 3 -1 
3 -1 3 -1 3 -1 3 -1 4 -1 4 -1 3 -1 3 -1 3 -1 4 -1 4 -1 3 -1 3 -1 3 -1 2 -1 2 -1 3 -1 3 -1 3 -1 3 -1 3 -1 3 -1 3 -1 3 -1 3 -1 3 -1 3 -1 4 -1 3 -1 3 -1 3 -1 3 -1 2 -1 3 -1 3 -1 3 -1 3 -1 3 -1 4 -1 3 -1 3 -1 3 -1 4 -1 3 -1 2 -1 2 -1 3 -1 3 -1 2 -1 2 -1 
3 -1 3 -1 3 -1 3 -1 3 -1 3 -1 3 -1 3 -1 3 -1 4 -1 3 -1 3 -1 3 -1 3 -1 3 -1 2 -1 3 -1 3 -1 3 -1 3 -1 3 -1 4 -1 3 -1 3 -1 403 -1 3 -1 3 -1 401 -1 3 -1 3 -1 3 -1 3 -1 3 -1 3 -1 3 -1 3 -1 3 -1 4 -1 4 -1 3 -1 4 -1 4 -1 4 -1 4 -1 4 -1 3 -1 3 -1 3 -1 3 -1 3 -1 
3 -1 3 -1 3 -1 4 -1 3 -1 3 -1 401 -1 3 -1 3 -1 3 -1 3 -1 3 -1 3 -1 3 -1 3 -1 3 -1 3 -1 3 -1 3 -1 3 -1 3 -1 4 -1 4 -1 3 -1 401 -1 3 -1 3 -1 4 -1 4 -1 3 -1 3 -1 3 -1 3 -1 3 -1 3 -1 4 -1 4 -1 4 -1 4 -1 3 -1 3 -1 3 -1 3 -1 4 -1 4 -1 3 -1 2 -1 3 -1 3 -1 3 -1 
3 -1 3 -1 3 -1 3 -1 4 -1 401 -1 3 -1 3 -1 3 -1 3 -1 4 -1 4 -1 3 -1 2 -1 3 -1 3 -1 3 -1 2 -1 3 -1 3 -1 3 -1 3 -1 4 -1 4 -1 3 -1 3 -1 4 -1 4 -1 3 -1 3 -1 3 -1 3 -1 3 -1 3 -1 4 -1 4 -1 4 -1 3 -1 3 -1 3 -1 3 -1 3 -1 3 -1 4 -1 4 -1 3 -1 2 -1 3 -1 2 -1 2 -1 
3 -1 3 -1 3 -1 3 -1 4 -1 4 -1 3 -1 3 -1 402 -1 4 -1 4 -1 4 -1 3 -1 2 -1 2 -1 2 -1 3 -1 3 -1 3 -1 3 -1 3 -1 3 -1 3 -1 4 -1 4 -1 3 -1 3 -1 3 -1 3 -1 3 -1 3 -1 3 -1 3 -1 3 -1 4 -1 401 -1 3 -1 3 -1 3 -1 402 -1 3 -1 3 -1 4 -1 4 -1 4 -1 3 -1 2 -1 3 -1 3 -1 3 -1 
2 -1 3 -1 3 -1 3 -1 3 -1 4 -1 4 -1 3 -1 3 -1 4 -1 4 -1 3 -1 3 -1 3 -1 3 -1 3 -1 3 -1 3 -1 3 -1 3 -1 3 -1 2 -1 3 -1 3 -1 3 -1 3 -1 3 -1 3 -1 3 -1 3 -1 3 -1 3 -1 3 -1 3 -1 4 -1 3 -1 3 -1 3 -1 401 -1 3 -1 3 -1 3 -1 3 -1 4 -1 4 -1 3 -1 2 -1 3 -1 2 -1 3 -1 
2 -1 2 -1 3 -1 3 -1 3 -1 3 -1 4 -1 3 -1 4 -1 3 -1 3 -1 3 -1 3 -1 3 -1 3 -1 3 -1 3 -1 3 -1 3 -1 3 -1 3 -1 2 -1 2 -1 3 -1 2 -1 3 -1 3 -1 3 -1 3 -1 3 -1 3 -1 3 -1 3 -1 3 -1 3 -1 3 -1 4 -1 4 -1 3 -1 3 -1 4 -1 3 -1 4 -1 4 -1 4 -1 3 -1 3 -1 3 -1 2 -1 3 -1 
3 -1 3 -1 3 -1 3 -1 3 -1 3 -1 3 -1 3 -1 3 -1 3 -1 3 -1 3 -1 3 -1 3 -1 3 -1 3 -1 3 -1 3 -1 3 -1 2 -1 3 -1 2 -1 2 -1 2 -1 3 -1 2 -1 2 -1 3 -1 3 -1 3 -1 2 -1 3 -1 3 -1 3 -1 3 -1 3 -1 4 -1 4 -1 4 -1 4 -1 4 -1 3 -1 4 -1 4 -1 3 -1 3 -1 2 -1 3 -1 3 -1 2 -1 
2 -1 3 -1 2 -1 3 -1 3 -1 3 -1 3 -1 2 -1 3 -1 3 -1 3 -1 3 -1 4 -1 4 -1 4 -1 4 -1 3 -1 3 -1 3 -1 3 -1 3 -1 2 -1 3 -1 2 -1 3 -1 3 -1 3 -1 2 -1 3 -1 3 -1 3 -1 3 -1 3 -1 2 -1 2 -1 3 -1 3 -1 3 -1 3 -1 4 -1 3 -1 3 -1 3 -1 3 -1 3 -1 3 -1 3 -1 2 -1 2 -1 2 -1 
2 -1 3 -1 3 -1 3 -1 3 -1 3 -1 3 -1 2 -1 3 -1 3 -1 3 -1 3 -1 4 -1 4 -1 3 -1 401 -1 3 -1 4 -1 4 -1 4 -1 3 -1 3 -1 3 -1 2 -1 2 -1 2 -1 3 -1 3 -1 3 -1 3 -1 3 -1 3 -1 3 -1 3 -1 2 -1 3 -1 3 -1 2 -1 3 -1 3 -1 3 -1 3 -1 3 -1 3 -1 3 -1 3 -1 3 -1 3 -1 3 -1 3 -1 
3 -1 2 -1 2 -1 2 -1 2 -1 3 -1 2 -1 3 -1 3 -1 3 -1 4 -1 3 -1 3 -1 3 -1 3 -1 3 -1 3 -1 401 -1 3 -1 4 -1 3 -1 2 -1 3 -1 3 -1 3 -1 3 -1 3 -1 4 -1 4 -1 4 -1 4 -1 4 -1 4 -1 3 -1 2 -1 2 -1 3 -1 3 -1 3 -1 2 -1 2 -1 2 -1 3 -1 3 -1 4 -1 4 -1 4 -1 4 -1 4 -1 3 -1 
3 -1 2 -1 3 -1 3 -1 2 -1 2 -1 2 -1 3 -1 3 -1 3 -1 4 -1 3 -1 3 -1 3 -1 3 -1 402 -1 3 -1 3 -1 3 -1 3 -1 3 -1 3 -1 3 -1 3 -1 3 -1 3 -1 4 -1 4 -1 4 -1 401 -1 3 -1 3 -1 3 -1 3 -1 3 -1 3 -1 3 -1 2 -1 3 -1 3 -1 3 -1 3 -1 3 -1 4 -1 4 -1 3 -1 4 -1 4 -1 4 -1 4 -1 
3 -1 3 -1 2 -1 2 -1 3 -1 3 -1 3 -1 3 -1 2 -1 3 -1 4 -1 4 -1 4 -1 3 -1 3 -1 3 -1 3 -1 3 -1 4 -1 3 -1 3 -1 3 -1 3 -1 3 -1 3 -1 3 -1 3 -1 4 -1 3 -1 3 -1 3 -1 3 -1 3 -1 4 -1 3 -1 3 -1 2 -1 3 -1 2 -1 3 -1 2 -1 3 -1 3 -1 4 -1 3 -1 3 -1 401 -1 401 -1 3 -1 4 -1 
3 -1 3 -1 3 -1 3 -1 2 -1 2 -1 3 -1 3 -1 3 -1 2 -1 3 -1 3 -1 4 -1 3 -1 3 -1 3 -1 3 -1 4 -1 4 -1 3 -1 3 -1 3 -1 3 -1 3 -1 3 -1 3 -1 3 -1 3 -1 3 -1 3 -1 3 -1 3 -1 3 -1 4 -1 4 -1 3 -1 2 -1 3 -1 2 -1 2 -1 3 -1 3 -1 3 -1 3 -1 3 -1 3 -1 3 -1 3 -1 3 -1 3 -1 
2 -1 3 -1 3 -1 3 -1 3 -1 3 -1 2 -1 3 -1 3 -1 3 -1 3 -1 3 -1 3 -1 3 -1 4 -1 4 -1 4 -1 4 -1 3 -1 3 -1 3 -1 2 -1 2 -1 3 -1 3 -1 3 -1 4 -1 3 -1 3 -1 3 -1 3 -1 3 -1 3 -1 4 -1 4 -1 2 -1 2 -1 3 -1 3 -1 2 -1 3 -1 3 -1 4 -1 3 -1 3 -1 3 -1 3 -1 3 -1 3 -1 3 -1 
2 -1 3 -1 2 -1 3 -1 2 -1 3 -1 3 -1 2 -1 2 -1 3 -1 3 -1 3 -1 3 -1 3 -1 3 -1 4 -1 3 -1 3 -1 3 -1 3 -1 2 -1 2 -1 3 -1 2 -1 3 -1 2 -1 4 -1 4 -1 3 -1 3 -1 403 -1 3 -1 401 -1 4 -1 4 -1 3 -1 2 -1 3 -1 3 -1 2 -1 3 -1 3 -1 4 -1 4 -1 3 -1 402 -1 3 -1 3 -1 3 -1 3 -1 
2 -1 2 -1 3 -1 3 -1 3 -1 3 -1 3 -1 3 -1 2 -1 2 -1 3 -1 2 -1 3 -1 3 -1 3 -1 3 -1 3 -1 3 -1 2 -1 3 -1 2 -1 3 -1 2 -1 3 -1 2 -1 2 -1 2 -1 4 -1 4 -1 4 -1 3 -1 4 -1 4 -1 4 -1 4 -1 3 -1 3 -1 3 -1 2 -1 3 -1 3 -1 3 -1 3 -1 3 -1 4 -1 4 -1 4 -1 4 -1 3 -1 3 -1 
-1
