20
18
4
400 0 3 -1 3 -1 3 -1 3 -1 3 -1 3 -1 4 -1 4 -1 2 -1 3 -1 3 -1 3 -1 2 -1 3 -1 3 -1 3 -1 3 -1 3 -1 400 1 
3 -1 3 -1 3 -1 2 -1 3 -1 3 -1 3 -1 3 -1 4 -1 4 -1 3 -1 3 -1 3 -1 3 -1 3 -1 3 -1 3 -1 2 -1 3 -1 3 -1 
3 -1 3 -1 2 -1 3 -1 3 -1 3 -1 2 -1 3 -1 3 -1 4 -1 4 -1 3 -1 3 -1 4 -1 3 -1 3 -1 3 -1 3 -1 3 -1 3 -1 
3 -1 3 -1 3 -1 2 -1 2 -1 2 -1 3 -1 3 -1 3 -1 4 -1 3 -1 3 -1 3 -1 2 -1 3 -1 3 -1 3 -1 3 -1 2 -1 2 -1 
3 -1 3 -1 3 -1 2 -1 3 -1 3 -1 3 -1 3 -1 3 -1 2 -1 2 -1 2 -1 3 -1 2 -1 2 -1 3 -1 3 -1 3 -1 3 -1 3 -1 
2 -1 3 -1 3 -1 4 -1 3 -1 3 -1 3 -1 3 -1 2 -1 2 -1 3 -1 4 -1 3 -1 2 -1 3 -1 3 -1 3 -1 3 -1 3 -1 3 -1 
2 -1 2 -1 3 -1 3 -1 2 -1 3 -1 3 -1 3 -1 3 -1 3 -1 3 -1 3 -1 3 -1 3 -1 3 -1 3 -1 2 -1 109 -1 103 -1 103 -1 
305 -1 401 -1 3 -1 2 -1 4 -1 4 -1 3 -1 2 -1 2 -1 3 -1 4 -1 3 -1 3 -1 3 -1 3 -1 3 -1 2 -1 105 -1 3 -1 3 -1 
229 -1 103 -1 1 -1 103 -1 103 -1 103 -1 103 -1 1 -1 108 -1 3 -1 4 -1 2 -1 2 -1 2 -1 3 -1 109 -1 1 -1 100 -1 3 -1 3 -1 
307 -1 3 -1 3 -1 3 -1 3 -1 3 -1 3 -1 3 -1 105 -1 3 -1 3 -1 3 -1 109 -1 1 -1 103 -1 100 -1 3 -1 3 -1 3 -1 3 -1 
2 -1 3 -1 3 -1 2 -1 3 -1 3 -1 3 -1 2 -1 101 -1 103 -1 103 -1 103 -1 100 -1 3 -1 3 -1 3 -1 3 -1 2 -1 2 -1 3 -1 
2 -1 2 -1 2 -1 3 -1 3 -1 3 -1 3 -1 3 -1 3 -1 2 -1 2 -1 3 -1 3 -1 3 -1 3 -1 3 -1 3 -1 3 -1 3 -1 3 -1 
3 -1 2 -1 3 -1 3 -1 3 -1 3 -1 3 -1 3 -1 3 -1 3 -1 2 -1 3 -1 3 -1 3 -1 3 -1 3 -1 2 -1 3 -1 3 -1 3 -1 
3 -1 3 -1 3 -1 3 -1 3 -1 3 -1 2 -1 3 -1 3 -1 3 -1 3 -1 3 -1 3 -1 3 -1 3 -1 3 -1 2 -1 2 -1 3 -1 3 -1 
400 3 3 -1 3 -1 3 -1 3 -1 3 -1 3 -1 3 -1 2 -1 4 -1 4 -1 3 -1 3 -1 3 -1 2 -1 3 -1 3 -1 2 -1 3 -1 400 2 
3 -1 3 -1 3 -1 3 -1 3 -1 3 -1 3 -1 2 -1 2 -1 4 -1 4 -1 2 -1 3 -1 3 -1 3 -1 3 -1 3 -1 3 -1 3 -1 3 -1 
3 -1 3 -1 3 -1 3 -1 3 -1 3 -1 2 -1 4 -1 4 -1 4 -1 4 -1 2 -1 2 -1 3 -1 3 -1 2 -1 3 -1 3 -1 3 -1 3 -1 
4 -1 4 -1 4 -1 4 -1 4 -1 4 -1 4 -1 4 -1 4 -1 4 -1 4 -1 4 -1 4 -1 4 -1 4 -1 4 -1 4 -1 4 -1 4 -1 4 -1 
6
0
0
0
1
4
0
0
4
2
1
0
2
3
3
0
4
4
10
0
2
5
13
0
4
3
14
0
5
2
17
0
3
4
17
0
2
2
12
0
5
1
3
0
3
3
16
0
15
0
12
1
15
3
17
1
18
4
17
1
17
2
16
1
16
2
14
1
17
4
13
1
14
3
10
1
14
1
3
1
17
3
3
1
15
2
1
1
17
0
0
1
15
4
0
1
13
13
0
2
18
11
0
2
16
13
1
2
19
11
3
2
14
12
3
2
17
11
10
2
13
12
13
2
15
12
14
2
15
13
16
2
15
11
17
2
12
12
17
2
1
11
17
3
4
12
17
3
4
14
12
3
1
12
16
3
3
12
14
3
2
11
13
3
2
12
10
3
4
11
3
3
0
12
3
3
2
13
1
3
1
14
0
3
0
10
0
3
5
4
20
0
14
4
20
1
14
11
20
2
5
12
20
3
15
14
12
2
1
13
6
3
19
13
12
2
19
1
12
1
4
0
12
0
1
0
9
0
18
0
9
1
0
13
9
3
18
14
9
2
3
14
14
3
17
12
14
2
19
2
14
1
0
3
14
0
2
1
6
0
18
1
6
1
18
13
6
2
3
13
12
3
5
10
15
3
6
4
15
0
14
5
15
1
14
10
15
2
0
1
7
0
0
2
7
0
5
0
7
0
6
1
7
0
16
0
7
1
17
1
7
1
18
2
7
1
19
3
7
1
18
15
7
2
17
15
7
2
19
12
7
2
19
10
7
2
2
15
7
3
3
15
7
3
0
11
7
3
1
10
7
3
-1
