20
20
2
4 -1 4 -1 4 -1 4 -1 4 -1 4 -1 4 -1 4 -1 4 -1 4 -1 4 -1 4 -1 4 -1 4 -1 4 -1 4 -1 4 -1 4 -1 4 -1 4 -1 
4 -1 4 -1 4 -1 4 -1 4 -1 9 -1 5 -1 5 -1 5 -1 5 -1 5 -1 5 -1 5 -1 5 -1 10 -1 3 -1 3 -1 401 -1 3 -1 4 -1 
4 -1 4 -1 400 0 401 0 3 -1 6 -1 3 -1 3 -1 3 -1 3 -1 3 -1 3 -1 3 -1 3 -1 6 -1 401 -1 401 -1 401 -1 401 -1 4 -1 
4 -1 4 -1 401 0 9 -1 5 -1 12 -1 5 -1 5 -1 5 -1 5 -1 13 -1 5 -1 5 -1 5 -1 12 -1 10 -1 403 -1 401 -1 3 -1 4 -1 
4 -1 4 -1 3 -1 6 -1 3 -1 3 -1 3 -1 3 -1 3 -1 3 -1 6 -1 3 -1 3 -1 3 -1 3 -1 7 -1 10 -1 401 -1 3 -1 4 -1 
4 -1 3 -1 3 -1 6 -1 3 -1 3 -1 3 -1 3 -1 3 -1 9 -1 8 -1 3 -1 3 -1 3 -1 3 -1 3 -1 6 -1 3 -1 3 -1 4 -1 
4 -1 3 -1 3 -1 6 -1 3 -1 402 0 3 -1 3 -1 9 -1 8 -1 404 0 322 -1 300 -1 305 -1 3 -1 3 -1 6 -1 3 -1 3 -1 4 -1 
4 -1 3 -1 3 -1 6 -1 3 -1 3 -1 3 -1 9 -1 8 -1 210 -1 203 -1 200 -1 200 -1 301 -1 3 -1 3 -1 6 -1 3 -1 3 -1 4 -1 
4 -1 3 -1 3 -1 6 -1 3 -1 3 -1 9 -1 8 -1 210 -1 223 -1 200 -1 200 -1 200 -1 319 -1 3 -1 3 -1 6 -1 402 -1 3 -1 4 -1 
4 -1 3 -1 3 -1 11 -1 5 -1 5 -1 8 -1 210 -1 223 -1 200 -1 200 -1 200 -1 224 -1 230 -1 103 -1 103 -1 6 -1 103 -1 103 -1 103 -1 
103 -1 103 -1 103 -1 6 -1 103 -1 103 -1 238 -1 223 -1 200 -1 200 -1 200 -1 224 -1 212 -1 9 -1 5 -1 5 -1 14 -1 3 -1 3 -1 4 -1 
4 -1 3 -1 402 -1 6 -1 3 -1 3 -1 317 -1 200 -1 200 -1 200 -1 224 -1 212 -1 9 -1 8 -1 3 -1 3 -1 6 -1 3 -1 3 -1 4 -1 
4 -1 3 -1 3 -1 6 -1 3 -1 3 -1 303 -1 200 -1 200 -1 205 -1 212 -1 9 -1 8 -1 3 -1 3 -1 3 -1 6 -1 3 -1 3 -1 4 -1 
4 -1 3 -1 3 -1 6 -1 3 -1 3 -1 306 -1 302 -1 320 -1 404 1 9 -1 8 -1 3 -1 3 -1 402 1 3 -1 6 -1 3 -1 3 -1 4 -1 
4 -1 3 -1 3 -1 6 -1 3 -1 3 -1 3 -1 3 -1 3 -1 9 -1 8 -1 3 -1 3 -1 3 -1 3 -1 3 -1 6 -1 3 -1 3 -1 4 -1 
4 -1 3 -1 401 -1 7 -1 10 -1 3 -1 3 -1 3 -1 3 -1 6 -1 3 -1 3 -1 3 -1 3 -1 3 -1 3 -1 6 -1 3 -1 4 -1 4 -1 
4 -1 3 -1 401 -1 403 -1 7 -1 13 -1 5 -1 5 -1 5 -1 12 -1 5 -1 5 -1 5 -1 5 -1 13 -1 5 -1 8 -1 401 1 4 -1 4 -1 
4 -1 401 -1 401 -1 401 -1 401 -1 6 -1 3 -1 3 -1 3 -1 3 -1 3 -1 3 -1 3 -1 3 -1 6 -1 3 -1 401 1 400 1 4 -1 4 -1 
4 -1 3 -1 401 -1 3 -1 3 -1 7 -1 5 -1 5 -1 5 -1 5 -1 5 -1 5 -1 5 -1 5 -1 8 -1 4 -1 4 -1 4 -1 4 -1 4 -1 
4 -1 4 -1 4 -1 4 -1 4 -1 4 -1 4 -1 4 -1 4 -1 4 -1 4 -1 4 -1 4 -1 4 -1 4 -1 4 -1 4 -1 4 -1 4 -1 4 -1 
-1
