50
50
2
2 -1 2 -1 3 -1 6 -1 2 -1 2 -1 2 -1 4 -1 4 -1 4 -1 4 -1 4 -1 4 -1 4 -1 4 -1 4 -1 4 -1 4 -1 105 -1 4 -1 4 -1 4 -1 4 -1 4 -1 4 -1 4 -1 4 -1 4 -1 4 -1 2 -1 2 -1 3 -1 3 -1 3 -1 3 -1 3 -1 3 -1 3 -1 3 -1 3 1 6 -1 3 -1 3 -1 3 -1 3 -1 3 -1 3 -1 3 -1 3 -1 3 -1 
2 -1 2 -1 3 -1 6 -1 3 -1 2 -1 2 -1 2 -1 4 -1 4 -1 4 -1 4 -1 4 -1 4 -1 4 -1 4 -1 4 -1 4 -1 105 -1 4 -1 4 -1 4 -1 4 -1 4 -1 4 -1 4 -1 4 -1 4 -1 2 -1 2 -1 3 -1 3 -1 3 -1 2 -1 2 -1 3 -1 3 -1 3 -1 3 -1 3 -1 6 -1 3 -1 2 -1 2 -1 401 1 3 -1 3 -1 3 -1 3 -1 3 -1 
2 -1 3 -1 3 -1 6 -1 3 -1 2 -1 2 -1 2 -1 2 -1 210 -1 208 -1 4 -1 218 -1 4 -1 4 -1 218 -1 4 -1 4 -1 105 -1 4 -1 4 -1 210 -1 203 -1 203 -1 208 -1 2 -1 2 -1 2 -1 2 -1 2 -1 3 -1 3 -1 3 -1 2 -1 3 -1 3 -1 3 -1 3 -1 3 -1 3 -1 6 -1 2 -1 2 -1 2 -1 2 -1 2 -1 3 -1 3 -1 3 -1 3 -1 
401 0 3 -1 3 -1 6 -1 3 -1 3 -1 2 -1 2 -1 2 -1 202 -1 222 -1 203 -1 228 -1 203 -1 203 -1 228 -1 203 -1 203 -1 200 -1 203 -1 203 -1 223 -1 200 -1 200 -1 204 -1 2 -1 2 -1 2 -1 2 -1 3 -1 402 1 3 -1 3 -1 3 -1 3 -1 3 -1 3 -1 3 -1 3 -1 2 -1 6 -1 2 -1 2 -1 2 -1 2 -1 3 -1 3 -1 3 -1 3 -1 3 -1 
3 -1 3 -1 3 -1 6 -1 3 -1 3 -1 3 -1 3 -1 3 -1 214 -1 225 -1 200 -1 201 -1 200 -1 200 -1 200 -1 200 -1 200 -1 200 -1 200 -1 200 -1 200 -1 200 -1 200 -1 204 -1 3 -1 2 -1 3 -1 3 -1 9 -1 5 -1 5 -1 5 -1 5 -1 5 -1 5 -1 5 -1 5 -1 5 -1 5 -1 14 -1 2 -1 2 -1 2 -1 2 -1 3 -1 3 -1 3 -1 3 -1 3 -1 
3 -1 3 -1 3 0 6 -1 3 -1 3 -1 3 -1 3 -1 3 -1 3 -1 202 -1 200 -1 200 -1 200 -1 200 -1 200 -1 200 -1 200 -1 200 -1 201 -1 200 -1 200 -1 200 -1 224 -1 212 -1 3 -1 3 -1 3 -1 3 -1 6 -1 2 -1 3 -1 3 -1 3 -1 3 -1 3 -1 3 -1 3 -1 3 -1 2 -1 6 -1 2 -1 400 1 2 -1 3 -1 3 -1 3 -1 3 -1 3 -1 3 -1 
3 -1 3 -1 3 -1 6 -1 3 -1 3 -1 3 -1 3 -1 3 -1 3 -1 214 -1 225 -1 200 -1 200 -1 200 -1 200 -1 200 -1 200 -1 200 -1 200 -1 200 -1 200 -1 200 -1 323 -1 3 -1 3 -1 3 -1 3 -1 3 -1 6 -1 3 -1 2 -1 2 -1 3 -1 3 -1 2 -1 2 -1 3 -1 3 -1 3 -1 6 -1 3 -1 3 -1 3 -1 3 -1 3 -1 3 -1 3 -1 3 -1 401 1 
401 0 3 -1 3 0 6 -1 3 -1 402 0 3 -1 3 -1 3 -1 3 -1 3 -1 317 -1 200 -1 200 -1 200 -1 200 -1 200 -1 200 -1 200 -1 200 -1 200 -1 200 -1 200 -1 310 -1 305 -1 3 -1 3 -1 3 -1 3 -1 6 -1 3 -1 3 -1 403 1 3 -1 3 -1 2 -1 2 -1 2 -1 2 -1 9 -1 12 -1 5 -1 5 -1 5 -1 5 -1 5 -1 5 -1 5 -1 5 -1 5 -1 
5 -1 5 -1 5 -1 12 -1 5 -1 5 -1 5 -1 5 -1 5 -1 5 -1 5 -1 0 -1 0 -1 0 -1 0 -1 200 -1 200 -1 200 -1 200 -1 200 -1 0 -1 0 -1 0 -1 0 -1 0 -1 5 -1 5 -1 5 -1 5 -1 8 -1 3 -1 3 -1 3 -1 2 -1 4 -1 2 -1 2 -1 3 -1 3 -1 18 -1 3 -1 3 -1 3 -1 3 -1 3 -1 3 -1 402 1 3 -1 3 -1 3 -1 
2 -1 2 -1 3 -1 3 -1 3 -1 3 -1 3 -1 3 -1 3 -1 3 -1 3 -1 303 -1 200 -1 200 -1 200 -1 200 -1 200 -1 200 -1 200 -1 200 -1 200 -1 200 -1 200 -1 200 -1 310 -1 300 -1 305 -1 3 -1 3 -1 3 -1 3 -1 3 -1 3 -1 2 -1 4 -1 4 -1 2 -1 2 -1 3 -1 3 -1 3 -1 3 -1 3 -1 210 -1 208 -1 3 -1 3 -1 3 -1 3 -1 3 -1 
2 -1 2 -1 2 -1 3 -1 3 -1 3 -1 3 -1 3 -1 3 -1 3 -1 304 -1 309 -1 200 -1 200 -1 200 -1 200 -1 200 -1 200 -1 200 -1 200 -1 200 -1 200 -1 200 -1 200 -1 200 -1 200 -1 310 -1 305 -1 3 -1 3 -1 3 -1 2 -1 2 -1 2 -1 4 -1 4 -1 2 -1 2 -1 2 -1 3 -1 3 -1 210 -1 203 -1 223 -1 222 -1 203 -1 203 -1 203 -1 208 -1 3 -1 
4 -1 2 -1 2 -1 2 -1 3 -1 3 -1 3 -1 3 -1 3 -1 3 -1 303 -1 200 -1 200 -1 200 -1 200 -1 200 -1 200 -1 200 -1 200 -1 200 -1 200 -1 200 -1 200 -1 200 -1 200 -1 200 -1 200 -1 310 -1 305 -1 3 -1 3 -1 3 -1 2 -1 2 -1 2 -1 4 -1 401 1 3 -1 2 -1 2 -1 3 -1 202 -1 200 -1 200 -1 200 -1 200 -1 200 -1 200 -1 222 -1 203 -1 
4 -1 4 -1 2 -1 400 0 3 -1 3 -1 3 -1 401 0 3 -1 3 -1 306 -1 308 -1 200 -1 200 -1 200 -1 200 -1 200 -1 200 -1 311 -1 302 -1 308 -1 200 -1 200 -1 200 -1 201 -1 200 -1 200 -1 200 -1 310 -1 305 -1 3 -1 3 -1 3 -1 2 -1 2 -1 2 -1 3 -1 3 -1 3 -1 3 -1 3 -1 202 -1 200 -1 200 -1 200 -1 200 -1 200 -1 200 -1 200 -1 200 -1 
4 -1 4 -1 2 -1 2 -1 3 -1 3 -1 3 -1 3 -1 3 -1 3 -1 304 -1 309 -1 200 -1 200 -1 200 -1 200 -1 200 -1 200 -1 301 -1 401 -1 306 -1 308 -1 200 -1 200 -1 200 -1 200 -1 200 -1 200 -1 200 -1 319 -1 3 -1 3 -1 3 -1 3 -1 3 -1 2 -1 3 -1 2 -1 2 -1 3 -1 210 -1 223 -1 200 -1 200 -1 200 -1 200 -1 200 -1 201 -1 200 -1 200 -1 
2 -1 2 -1 2 -1 2 -1 3 -1 3 -1 3 -1 3 -1 3 -1 404 0 200 -1 200 -1 200 -1 200 -1 200 -1 200 -1 224 -1 316 -1 307 -1 3 -1 3 -1 306 -1 320 -1 225 -1 200 -1 200 -1 200 -1 200 -1 200 -1 200 -1 404 1 322 -1 305 -1 3 -1 3 -1 3 -1 3 -1 3 -1 3 -1 17 -1 202 -1 200 -1 200 -1 200 -1 200 -1 200 -1 200 -1 200 -1 200 -1 200 -1 
2 -1 2 -1 2 -1 401 0 3 -1 3 -1 3 -1 3 -1 304 -1 200 -1 200 -1 200 -1 200 -1 201 -1 200 -1 200 -1 204 -1 3 -1 3 -1 3 -1 3 -1 3 -1 3 -1 214 -1 225 -1 200 -1 200 -1 200 -1 200 -1 200 -1 200 -1 200 -1 310 -1 305 -1 3 -1 3 -1 3 -1 401 1 3 -1 6 -1 214 -1 205 -1 225 -1 200 -1 200 -1 200 -1 200 -1 200 -1 200 -1 200 -1 
2 -1 2 -1 2 -1 2 -1 3 -1 3 -1 3 -1 304 -1 309 -1 200 -1 200 -1 200 -1 200 -1 200 -1 200 -1 200 -1 222 -1 300 -1 305 -1 3 -1 402 -1 3 -1 3 -1 3 -1 202 -1 200 -1 200 -1 200 -1 200 -1 200 -1 200 -1 200 -1 200 -1 310 -1 305 -1 3 -1 3 -1 3 -1 3 -1 6 -1 3 -1 3 -1 202 -1 200 -1 200 -1 200 -1 200 -1 200 -1 200 -1 200 -1 
3 -1 2 -1 2 -1 3 -1 3 -1 3 -1 3 -1 306 -1 302 -1 308 -1 200 -1 200 -1 200 -1 200 -1 200 -1 200 -1 200 -1 200 -1 301 -1 401 -1 3 -1 3 -1 3 -1 210 -1 223 -1 200 -1 200 -1 200 -1 200 -1 200 -1 200 -1 200 -1 200 -1 200 -1 310 -1 305 -1 3 -1 3 -1 3 -1 6 -1 3 -1 210 -1 223 -1 200 -1 200 -1 200 -1 200 -1 200 -1 200 -1 200 -1 
3 -1 3 -1 3 -1 3 -1 3 -1 3 -1 3 -1 3 -1 3 -1 306 -1 302 -1 308 -1 200 -1 200 -1 200 -1 200 -1 200 -1 200 -1 310 -1 300 -1 305 -1 3 -1 401 -1 317 -1 200 -1 200 -1 200 -1 200 -1 200 -1 200 -1 200 -1 200 -1 200 -1 200 -1 200 -1 310 -1 318 -1 203 -1 203 -1 1 -1 203 -1 223 -1 200 -1 200 -1 200 -1 200 -1 200 -1 200 -1 200 -1 200 -1 
208 -1 3 -1 3 -1 3 -1 3 -1 3 -1 3 -1 3 -1 3 -1 3 -1 3 -1 303 -1 200 -1 200 -1 200 -1 200 -1 200 -1 200 -1 200 -1 200 -1 310 -1 300 -1 300 -1 309 -1 200 -1 200 -1 200 -1 200 -1 200 -1 200 -1 200 -1 200 -1 200 -1 200 -1 200 -1 200 -1 200 -1 200 -1 200 -1 1 -1 200 -1 200 -1 200 -1 200 -1 201 -1 200 -1 200 -1 200 -1 200 -1 200 -1 
212 -1 3 -1 402 0 2 -1 3 -1 3 -1 403 0 3 -1 3 -1 3 -1 3 -1 306 -1 308 -1 200 -1 200 -1 200 -1 200 -1 200 -1 200 -1 200 -1 200 -1 200 -1 200 -1 200 -1 200 -1 200 -1 200 -1 200 -1 200 -1 200 -1 200 -1 200 -1 200 -1 200 -1 200 -1 200 -1 200 -1 200 -1 200 -1 200 -1 200 -1 200 -1 200 -1 200 -1 200 -1 200 -1 200 -1 200 -1 200 -1 200 -1 
2 -1 2 -1 2 -1 2 -1 2 -1 3 -1 3 -1 3 -1 3 -1 3 -1 3 -1 3 -1 303 -1 200 -1 200 -1 200 -1 200 -1 200 -1 200 -1 200 -1 200 -1 200 -1 200 -1 200 -1 200 -1 200 -1 200 -1 200 -1 200 -1 200 -1 201 -1 200 -1 200 -1 200 -1 200 -1 200 -1 200 -1 200 -1 200 -1 200 -1 200 -1 200 -1 200 -1 200 -1 200 -1 200 -1 200 -1 200 -1 200 -1 200 -1 
2 -1 2 -1 2 -1 2 -1 2 -1 3 -1 3 -1 3 -1 3 -1 210 -1 203 -1 322 -1 309 -1 200 -1 200 -1 200 -1 200 -1 200 -1 200 -1 200 -1 200 -1 200 -1 201 -1 200 -1 200 -1 200 -1 200 -1 200 -1 200 -1 200 -1 200 -1 200 -1 200 -1 200 -1 200 -1 200 -1 311 -1 302 -1 302 -1 1 -1 302 -1 320 -1 205 -1 205 -1 225 -1 200 -1 200 -1 200 -1 200 -1 200 -1 
2 -1 2 -1 2 -1 2 -1 3 -1 3 -1 3 -1 3 -1 210 -1 223 -1 200 -1 200 -1 200 -1 200 -1 200 -1 200 -1 200 -1 200 -1 200 -1 200 -1 200 -1 200 -1 200 -1 200 -1 200 -1 200 -1 200 -1 200 -1 200 -1 200 -1 200 -1 200 -1 200 -1 200 -1 200 -1 200 -1 301 -1 3 -1 3 -1 6 -1 3 -1 3 -1 3 -1 3 -1 214 -1 225 -1 200 -1 200 -1 200 -1 200 -1 
2 -1 2 -1 2 -1 3 -1 3 -1 210 -1 203 -1 203 -1 223 -1 200 -1 200 -1 200 -1 200 -1 200 -1 200 -1 200 -1 200 -1 200 -1 200 -1 200 -1 200 -1 200 -1 200 -1 200 -1 200 -1 200 -1 200 -1 200 -1 200 -1 200 -1 200 -1 200 -1 200 -1 200 -1 200 -1 200 -1 310 -1 305 -1 3 -1 18 -1 3 -1 3 -1 3 -1 3 -1 3 -1 202 -1 200 -1 200 -1 200 -1 200 -1 
2 -1 2 -1 2 -1 210 -1 203 -1 223 -1 200 -1 200 -1 200 -1 200 -1 200 -1 200 -1 200 -1 200 -1 200 -1 200 -1 200 -1 200 -1 200 -1 200 -1 200 -1 200 -1 200 -1 200 -1 200 -1 200 -1 200 -1 200 -1 200 -1 200 -1 200 -1 200 -1 200 -1 200 -1 311 -1 302 -1 302 -1 307 -1 3 -1 3 -1 3 -1 3 -1 3 -1 3 -1 3 -1 202 -1 200 -1 200 -1 200 -1 200 -1 
2 -1 2 -1 210 -1 223 -1 200 -1 200 -1 200 -1 200 -1 200 -1 200 -1 200 -1 200 -1 200 -1 200 -1 200 -1 201 -1 200 -1 200 -1 200 -1 200 -1 200 -1 200 -1 200 -1 200 -1 200 -1 200 -1 200 -1 200 -1 200 -1 200 -1 200 -1 200 -1 200 -1 200 -1 301 -1 401 -1 3 -1 3 -1 3 -1 3 -1 3 -1 3 -1 216 -1 209 -1 3 -1 202 -1 200 -1 200 -1 200 -1 200 -1 
17 -1 210 -1 223 -1 200 -1 200 -1 200 -1 200 -1 200 -1 200 -1 200 -1 200 -1 200 -1 200 -1 200 -1 200 -1 200 -1 200 -1 200 -1 200 -1 200 -1 200 -1 200 -1 200 -1 201 -1 200 -1 200 -1 200 -1 200 -1 200 -1 200 -1 200 -1 200 -1 200 -1 200 -1 301 -1 3 -1 304 -1 305 -1 3 -1 3 -1 3 -1 3 -1 3 -1 215 -1 238 -1 223 -1 200 -1 200 -1 200 -1 200 -1 
1 -1 223 -1 200 -1 200 -1 200 -1 200 -1 200 -1 200 -1 200 -1 200 -1 200 -1 200 -1 200 -1 200 -1 200 -1 200 -1 200 -1 200 -1 200 -1 200 -1 200 -1 200 -1 200 -1 200 -1 200 -1 200 -1 200 -1 200 -1 200 -1 200 -1 200 -1 200 -1 200 -1 200 -1 301 -1 3 -1 303 -1 301 -1 3 -1 3 -1 3 -1 401 -1 3 -1 3 -1 202 -1 200 -1 200 -1 200 -1 200 -1 200 -1 
1 -1 200 -1 200 -1 200 -1 200 -1 201 -1 200 -1 200 -1 200 -1 200 -1 200 -1 200 -1 200 -1 200 -1 200 -1 200 -1 200 -1 200 -1 200 -1 200 -1 200 -1 200 -1 200 -1 200 -1 200 -1 200 -1 200 -1 200 -1 200 -1 200 -1 201 -1 200 -1 200 -1 200 -1 310 -1 300 -1 309 -1 310 -1 404 -1 318 -1 203 -1 208 -1 3 -1 210 -1 223 -1 200 -1 200 -1 200 -1 200 -1 200 -1 
1 -1 225 -1 200 -1 200 -1 200 -1 200 -1 200 -1 200 -1 200 -1 200 -1 200 -1 200 -1 200 -1 200 -1 200 -1 200 -1 200 -1 200 -1 200 -1 200 -1 200 -1 200 -1 200 -1 200 -1 200 -1 200 -1 200 -1 200 -1 200 -1 200 -1 200 -1 200 -1 200 -1 200 -1 200 -1 200 -1 200 -1 200 -1 200 -1 200 -1 200 -1 222 -1 203 -1 223 -1 200 -1 200 -1 200 -1 200 -1 200 -1 200 -1 
18 -1 214 -1 225 -1 200 -1 200 -1 200 -1 200 -1 200 -1 200 -1 200 -1 200 -1 200 -1 200 -1 200 -1 200 -1 200 -1 200 -1 200 -1 201 -1 200 -1 200 -1 200 -1 200 -1 200 -1 200 -1 200 -1 200 -1 200 -1 200 -1 200 -1 200 -1 200 -1 200 -1 200 -1 200 -1 200 -1 200 -1 200 -1 200 -1 200 -1 200 -1 200 -1 200 -1 200 -1 200 -1 200 -1 200 -1 201 -1 200 -1 200 -1 
2 -1 2 -1 202 -1 200 -1 200 -1 224 -1 205 -1 404 -1 308 -1 311 -1 302 -1 308 -1 200 -1 200 -1 200 -1 200 -1 200 -1 200 -1 200 -1 200 -1 200 -1 200 -1 311 -1 302 -1 302 -1 308 -1 200 -1 200 -1 200 -1 200 -1 200 -1 200 -1 200 -1 200 -1 200 -1 200 -1 200 -1 200 -1 200 -1 200 -1 200 -1 200 -1 200 -1 200 -1 200 -1 200 -1 200 -1 200 -1 200 -1 200 -1 
2 -1 2 -1 202 -1 200 -1 224 -1 212 -1 3 -1 3 -1 306 -1 307 -1 3 -1 303 -1 200 -1 200 -1 200 -1 200 -1 200 -1 200 -1 200 -1 200 -1 200 -1 200 -1 301 -1 3 -1 3 -1 303 -1 200 -1 200 -1 200 -1 200 -1 200 -1 200 -1 200 -1 200 -1 200 -1 200 -1 200 -1 200 -1 200 -1 200 -1 200 -1 200 -1 200 -1 200 -1 200 -1 200 -1 200 -1 200 -1 200 -1 200 -1 
2 -1 3 -1 234 -1 312 -1 212 -1 3 -1 3 -1 3 -1 3 -1 3 -1 3 -1 303 -1 200 -1 200 -1 200 -1 200 -1 200 -1 200 -1 200 -1 200 -1 200 -1 311 -1 307 -1 3 -1 304 -1 309 -1 311 -1 308 -1 200 -1 200 -1 200 -1 200 -1 200 -1 200 -1 200 -1 200 -1 200 -1 200 -1 201 -1 200 -1 200 -1 200 -1 200 -1 200 -1 200 -1 200 -1 200 -1 200 -1 200 -1 200 -1 
2 -1 3 -1 217 -1 3 -1 3 -1 3 -1 3 -1 210 -1 208 -1 3 -1 304 -1 309 -1 200 -1 200 -1 200 -1 200 -1 200 -1 200 -1 200 -1 200 -1 311 -1 307 -1 3 -1 3 -1 306 -1 302 -1 307 -1 306 -1 308 -1 200 -1 200 -1 200 -1 200 -1 200 -1 200 -1 200 -1 200 -1 200 -1 200 -1 200 -1 200 -1 200 -1 200 -1 200 -1 200 -1 200 -1 200 -1 200 -1 200 -1 200 -1 
2 -1 3 -1 3 -1 3 -1 3 -1 3 -1 3 -1 313 -1 222 -1 322 -1 309 -1 200 -1 200 -1 200 -1 200 -1 201 -1 200 -1 200 -1 311 -1 302 -1 307 -1 3 -1 401 -1 3 -1 3 -1 2 -1 3 -1 3 -1 303 -1 200 -1 200 -1 200 -1 200 -1 201 -1 200 -1 200 -1 200 -1 200 -1 200 -1 200 -1 200 -1 200 -1 200 -1 200 -1 200 -1 200 -1 200 -1 200 -1 311 -1 302 -1 
3 -1 3 -1 3 -1 401 -1 3 -1 3 -1 3 -1 214 -1 225 -1 200 -1 200 -1 200 -1 200 -1 200 -1 200 -1 200 -1 200 -1 200 -1 319 -1 3 -1 3 -1 3 -1 2 -1 2 -1 3 -1 3 -1 3 -1 3 -1 321 -1 200 -1 200 -1 200 -1 200 -1 200 -1 200 -1 200 -1 200 -1 200 -1 200 -1 200 -1 200 -1 200 -1 200 -1 200 -1 200 -1 200 -1 200 -1 200 -1 301 -1 3 -1 
3 -1 3 -1 3 -1 3 -1 3 -1 3 -1 3 -1 3 -1 317 -1 200 -1 200 -1 200 -1 200 -1 200 -1 200 -1 200 -1 200 -1 224 -1 230 -1 209 -1 3 -1 403 -1 2 -1 2 -1 218 -1 3 -1 3 -1 210 -1 223 -1 200 -1 200 -1 200 -1 200 -1 200 -1 200 -1 200 -1 200 -1 200 -1 200 -1 200 -1 200 -1 200 -1 200 -1 201 -1 200 -1 200 -1 200 -1 200 -1 301 -1 3 -1 
3 -1 3 -1 3 -1 3 -1 218 -1 401 -1 3 -1 3 -1 321 -1 200 -1 200 -1 200 -1 200 -1 200 -1 200 -1 200 -1 200 -1 323 -1 3 -1 217 -1 3 -1 3 -1 3 -1 216 -1 233 -1 203 -1 203 -1 223 -1 200 -1 200 -1 200 -1 200 -1 200 -1 200 -1 200 -1 200 -1 200 -1 200 -1 200 -1 200 -1 200 -1 200 -1 200 -1 200 -1 200 -1 200 -1 200 -1 311 -1 307 -1 3 -1 
208 -1 3 -1 3 -1 3 -1 235 -1 203 -1 203 -1 203 -1 223 -1 200 -1 200 -1 200 -1 200 -1 200 -1 200 -1 200 -1 200 -1 301 -1 3 -1 3 -1 3 -1 402 -1 401 -1 3 -1 313 -1 200 -1 200 -1 200 -1 200 -1 200 -1 200 -1 200 -1 200 -1 200 -1 200 -1 200 -1 200 -1 200 -1 200 -1 200 -1 200 -1 200 -1 200 -1 200 -1 200 -1 200 -1 200 -1 301 -1 3 -1 3 -1 
222 -1 203 -1 314 -1 203 -1 223 -1 200 -1 200 -1 200 -1 200 -1 200 -1 200 -1 200 -1 200 -1 200 -1 200 -1 200 -1 311 -1 307 -1 3 -1 3 -1 2 -1 3 -1 3 -1 210 -1 223 -1 200 -1 200 -1 200 -1 200 -1 200 -1 200 -1 200 -1 200 -1 200 -1 200 -1 200 -1 200 -1 200 -1 200 -1 200 -1 200 -1 200 -1 200 -1 200 -1 200 -1 200 -1 200 -1 301 -1 3 -1 3 -1 
200 -1 200 -1 200 -1 200 -1 200 -1 200 -1 200 -1 200 -1 200 -1 200 -1 200 -1 200 -1 200 -1 200 -1 200 -1 200 -1 319 -1 3 -1 3 -1 210 -1 203 -1 314 -1 203 -1 223 -1 200 -1 200 -1 200 -1 200 -1 200 -1 200 -1 200 -1 200 -1 200 -1 200 -1 200 -1 200 -1 200 -1 200 -1 200 -1 200 -1 200 -1 200 -1 311 -1 302 -1 308 -1 200 -1 311 -1 307 -1 3 -1 3 -1 
200 -1 200 -1 200 -1 200 -1 200 -1 200 -1 200 -1 200 -1 200 -1 200 -1 200 -1 200 -1 200 -1 200 -1 200 -1 200 -1 222 -1 314 -1 314 -1 223 -1 200 -1 200 -1 200 -1 200 -1 200 -1 200 -1 200 -1 200 -1 200 -1 200 -1 200 -1 200 -1 201 -1 200 -1 200 -1 200 -1 200 -1 200 -1 200 -1 200 -1 224 -1 316 -1 307 -1 3 -1 306 -1 302 -1 307 -1 3 -1 3 -1 3 -1 
200 -1 200 -1 200 -1 200 -1 200 -1 200 -1 200 -1 200 -1 200 -1 201 -1 200 -1 200 -1 200 -1 200 -1 200 -1 200 -1 200 -1 200 -1 200 -1 200 -1 200 -1 200 -1 200 -1 200 -1 200 -1 200 -1 200 -1 200 -1 200 -1 200 -1 200 -1 200 -1 200 -1 200 -1 200 -1 200 -1 200 -1 200 -1 224 -1 205 -1 212 -1 3 -1 3 -1 3 -1 3 -1 3 -1 3 -1 3 -1 2 -1 2 -1 
200 -1 200 -1 200 -1 200 -1 200 -1 200 -1 200 -1 200 -1 200 -1 200 -1 200 -1 200 -1 200 -1 200 -1 200 -1 200 -1 200 -1 200 -1 200 -1 200 -1 200 -1 200 -1 200 -1 200 -1 200 -1 200 -1 200 -1 200 -1 200 -1 200 -1 200 -1 200 -1 200 -1 200 -1 200 -1 200 -1 200 -1 200 -1 404 -1 3 -1 3 -1 3 -1 401 -1 3 -1 3 -1 3 -1 3 -1 2 -1 2 -1 2 -1 
200 -1 200 -1 200 -1 200 -1 200 -1 200 -1 200 -1 200 -1 200 -1 200 -1 200 -1 200 -1 200 -1 200 -1 200 -1 200 -1 200 -1 200 -1 200 -1 200 -1 200 -1 200 -1 200 -1 200 -1 200 -1 200 -1 200 -1 200 -1 200 -1 200 -1 200 -1 200 -1 200 -1 200 -1 200 -1 200 -1 200 -1 200 -1 222 -1 208 -1 3 -1 3 -1 3 -1 3 -1 3 -1 3 -1 2 -1 2 -1 2 -1 2 -1 
200 -1 200 -1 200 -1 200 -1 200 -1 200 -1 200 -1 200 -1 200 -1 200 -1 200 -1 200 -1 200 -1 200 -1 200 -1 200 -1 200 -1 200 -1 200 -1 200 -1 200 -1 200 -1 200 -1 200 -1 200 -1 200 -1 200 -1 200 -1 200 -1 200 -1 200 -1 200 -1 200 -1 200 -1 200 -1 200 -1 200 -1 200 -1 200 -1 222 -1 208 -1 3 -1 3 -1 3 -1 3 -1 2 -1 2 -1 2 -1 4 -1 2 -1 
200 -1 200 -1 200 -1 200 -1 200 -1 200 -1 200 -1 200 -1 200 -1 200 -1 200 -1 200 -1 200 -1 200 -1 200 -1 200 -1 200 -1 200 -1 200 -1 200 -1 200 -1 200 -1 200 -1 200 -1 201 -1 200 -1 200 -1 200 -1 200 -1 200 -1 200 -1 200 -1 200 -1 200 -1 200 -1 200 -1 200 -1 200 -1 200 -1 200 -1 323 -1 3 -1 3 -1 3 -1 2 -1 2 -1 2 -1 4 -1 4 -1 4 -1 
200 -1 200 -1 200 -1 200 -1 200 -1 200 -1 200 -1 200 -1 200 -1 200 -1 200 -1 200 -1 200 -1 200 -1 200 -1 200 -1 200 -1 200 -1 200 -1 200 -1 200 -1 200 -1 200 -1 200 -1 200 -1 200 -1 200 -1 200 -1 200 -1 200 -1 200 -1 200 -1 200 -1 200 -1 200 -1 200 -1 200 -1 200 -1 200 -1 311 -1 307 -1 3 -1 401 -1 3 -1 2 -1 2 -1 2 -1 4 -1 4 -1 4 -1 
-1
