25
20
3
2 -1 401 -1 2 -1 2 -1 2 -1 3 -1 3 -1 6 -1 3 -1 303 -1 200 -1 201 -1 200 -1 200 -1 200 -1 200 -1 201 -1 200 -1 200 -1 200 -1 200 -1 200 -1 200 -1 200 -1 200 -1 
2 -1 2 -1 2 -1 2 -1 2 -1 2 -1 2 -1 6 -1 3 -1 321 -1 200 -1 200 -1 200 -1 200 -1 200 -1 200 -1 200 -1 200 -1 224 -1 205 -1 205 -1 205 -1 205 -1 205 -1 205 -1 
2 -1 2 -1 401 0 2 -1 2 -1 2 -1 401 0 6 -1 3 -1 214 -1 200 -1 200 -1 200 -1 200 -1 200 -1 200 -1 200 -1 224 -1 212 -1 4 -1 4 -1 4 -1 4 -1 4 -1 4 -1 
2 -1 2 -1 2 -1 3 -1 2 -1 3 -1 3 -1 6 -1 3 -1 3 -1 404 -1 200 -1 200 -1 200 -1 200 -1 200 -1 224 -1 404 -1 4 -1 4 -1 2 -1 2 -1 401 2 3 -1 401 2 
403 -1 2 -1 3 -1 3 -1 400 0 3 -1 3 -1 6 -1 3 -1 3 -1 3 -1 214 -1 225 -1 200 -1 200 -1 200 -1 323 -1 3 -1 3 -1 3 -1 3 -1 3 -1 3 -1 3 -1 3 -1 
3 -1 3 -1 3 -1 3 -1 3 -1 3 -1 402 0 6 -1 3 -1 3 -1 3 -1 3 -1 202 -1 200 -1 201 -1 200 -1 301 -1 3 -1 3 -1 401 -1 3 -1 3 -1 3 -1 400 2 3 -1 
3 -1 401 0 3 -1 3 -1 3 -1 3 -1 3 -1 6 -1 3 -1 3 -1 210 -1 203 -1 223 -1 200 -1 200 -1 200 -1 301 -1 3 -1 3 -1 3 -1 3 -1 3 -1 3 -1 3 -1 3 -1 
5 -1 5 -1 5 -1 5 -1 5 -1 5 -1 5 -1 14 -1 3 -1 3 -1 317 -1 200 -1 200 -1 200 -1 200 -1 200 -1 319 -1 3 -1 401 -1 3 -1 3 -1 402 2 3 -1 3 -1 401 2 
3 -1 3 -1 3 -1 3 -1 3 -1 2 -1 3 -1 6 -1 401 -1 3 -1 306 -1 302 -1 302 -1 302 -1 308 -1 200 -1 222 -1 203 -1 208 -1 4 -1 4 -1 2 -1 2 -1 3 -1 3 -1 
3 -1 3 -1 3 -1 2 -1 2 -1 2 -1 3 -1 6 -1 3 -1 3 -1 3 -1 3 -1 401 -1 3 -1 303 -1 200 -1 200 -1 200 -1 222 -1 208 -1 4 -1 4 -1 4 -1 3 -1 3 -1 
4 -1 4 -1 2 -1 4 -1 4 -1 2 -1 4 -1 6 -1 4 -1 3 -1 3 -1 401 -1 3 -1 401 -1 303 -1 200 -1 200 -1 200 -1 200 -1 222 -1 239 -1 206 -1 404 -1 3 -1 3 -1 
3 -1 2 -1 401 -1 2 -1 4 -1 401 -1 2 -1 6 -1 401 -1 3 -1 3 -1 304 -1 300 -1 300 -1 309 -1 201 -1 200 -1 200 -1 224 -1 205 -1 212 -1 4 -1 4 -1 3 -1 3 -1 
401 -1 2 -1 2 -1 2 -1 4 -1 402 -1 2 -1 6 -1 3 -1 3 -1 3 -1 303 -1 200 -1 200 -1 200 -1 200 -1 200 -1 224 -1 212 -1 4 -1 4 -1 4 -1 2 -1 3 -1 403 -1 
3 -1 3 -1 2 -1 2 -1 4 -1 2 -1 3 -1 6 -1 3 -1 3 -1 3 -1 321 -1 200 -1 200 -1 200 -1 200 -1 200 -1 323 -1 3 -1 401 -1 3 -1 3 -1 3 -1 3 -1 3 -1 
4 -1 3 -1 3 -1 3 -1 4 -1 3 -1 3 -1 6 -1 3 -1 3 -1 3 -1 3 -1 313 -1 200 -1 200 -1 200 -1 200 -1 319 -1 3 -1 3 -1 401 -1 3 -1 3 -1 3 -1 2 -1 
4 -1 4 -1 4 -1 3 -1 4 -1 3 -1 4 -1 6 -1 4 -1 3 -1 210 -1 203 -1 223 -1 200 -1 200 -1 200 -1 200 -1 222 -1 208 -1 4 -1 4 -1 4 -1 2 -1 2 -1 401 -1 
4 -1 4 -1 3 -1 3 -1 3 -1 3 -1 3 -1 6 -1 3 -1 3 -1 214 -1 316 -1 302 -1 302 -1 320 -1 225 -1 200 -1 200 -1 222 -1 203 -1 208 -1 4 -1 404 -1 4 -1 4 -1 
4 -1 401 -1 3 -1 3 -1 3 -1 3 -1 3 -1 6 -1 3 -1 401 1 3 -1 3 -1 3 -1 3 -1 401 -1 202 -1 200 -1 200 -1 200 -1 200 -1 222 -1 203 -1 200 -1 203 -1 203 -1 
403 -1 3 -1 3 -1 3 -1 3 -1 3 -1 3 -1 6 -1 3 -1 3 -1 3 -1 3 -1 3 -1 3 -1 216 -1 223 -1 200 -1 200 -1 200 -1 201 -1 200 -1 200 -1 200 -1 200 -1 200 -1 
4 -1 4 -1 4 -1 4 -1 3 -1 402 1 3 -1 6 -1 400 1 3 -1 401 1 3 -1 3 -1 401 1 3 -1 404 -1 200 -1 200 -1 200 -1 200 -1 200 -1 200 -1 200 -1 200 -1 200 -1 
-1
