50
18
2
200 -1 200 -1 200 -1 200 -1 200 -1 200 -1 200 -1 200 -1 200 -1 200 -1 200 -1 200 -1 200 -1 301 -1 401 -1 2 -1 2 -1 306 -1 225 -1 200 -1 200 -1 200 -1 200 -1 200 -1 200 -1 200 -1 200 -1 200 -1 200 -1 200 -1 200 -1 200 -1 200 -1 200 -1 200 -1 200 -1 200 -1 200 -1 200 -1 200 -1 200 -1 200 -1 200 -1 200 -1 200 -1 200 -1 200 -1 200 -1 200 -1 201 -1 
200 -1 200 -1 200 -1 201 -1 200 -1 200 -1 200 -1 200 -1 200 -1 200 -1 200 -1 200 -1 200 -1 301 -1 3 -1 2 -1 3 -1 404 -1 202 -1 200 -1 200 -1 200 -1 200 -1 200 -1 200 -1 200 -1 200 -1 200 -1 200 -1 200 -1 200 -1 200 -1 200 -1 200 -1 311 -1 302 -1 324 -1 302 -1 308 -1 200 -1 200 -1 200 -1 201 -1 200 -1 200 -1 200 -1 311 -1 302 -1 302 -1 302 -1 
200 -1 200 -1 200 -1 200 -1 200 -1 200 -1 200 -1 200 -1 200 -1 200 -1 200 -1 200 -1 200 -1 310 -1 300 -1 305 -1 401 -1 304 -1 223 -1 200 -1 200 -1 201 -1 200 -1 200 -1 200 -1 200 -1 200 -1 200 -1 200 -1 200 -1 200 -1 200 -1 200 -1 224 -1 307 -1 2 -1 4 -1 3 -1 303 -1 200 -1 200 -1 200 -1 200 -1 200 -1 311 -1 302 -1 307 -1 3 -1 3 -1 3 -1 
200 -1 200 -1 200 -1 200 -1 200 -1 200 -1 200 -1 200 -1 200 -1 200 -1 200 -1 200 -1 200 -1 200 -1 200 -1 310 -1 300 -1 309 -1 200 -1 200 -1 200 -1 200 -1 200 -1 311 -1 302 -1 302 -1 308 -1 200 -1 200 -1 200 -1 200 -1 200 -1 200 -1 204 -1 404 -1 3 -1 401 -1 2 -1 303 -1 200 -1 200 -1 200 -1 200 -1 200 -1 301 -1 403 1 3 -1 3 -1 402 1 3 -1 
200 -1 200 -1 200 -1 200 -1 200 -1 200 -1 200 -1 200 -1 200 -1 200 -1 201 -1 200 -1 200 -1 200 -1 200 -1 200 -1 200 -1 200 -1 200 -1 200 -1 200 -1 200 -1 200 -1 301 -1 403 -1 401 -1 303 -1 200 -1 200 -1 200 -1 200 -1 200 -1 200 -1 222 -1 300 -1 326 -1 305 -1 401 -1 325 -1 200 -1 200 -1 200 -1 200 -1 200 -1 301 -1 3 -1 3 -1 2 -1 3 -1 3 -1 
302 -1 302 -1 302 -1 308 -1 200 -1 200 -1 200 -1 200 -1 200 -1 200 -1 200 -1 200 -1 200 -1 200 -1 200 -1 200 -1 200 -1 200 -1 200 -1 200 -1 200 -1 200 -1 311 -1 307 -1 3 -1 3 -1 306 -1 308 -1 200 -1 200 -1 201 -1 200 -1 200 -1 200 -1 200 -1 200 -1 310 -1 300 -1 309 -1 200 -1 200 -1 200 -1 200 -1 200 -1 301 -1 401 -1 3 -1 3 1 401 -1 4 -1 
2 -1 3 -1 3 -1 303 -1 200 -1 200 -1 200 -1 200 -1 200 -1 200 -1 200 -1 200 -1 200 -1 200 -1 311 -1 302 -1 302 -1 308 -1 200 -1 200 -1 200 -1 311 -1 307 -1 3 -1 3 -1 3 -1 3 -1 303 -1 200 -1 200 -1 200 -1 200 -1 200 -1 200 -1 200 -1 200 -1 200 -1 200 -1 200 -1 200 -1 200 -1 200 -1 200 -1 200 -1 310 -1 300 -1 404 1 300 -1 2 -1 401 -1 
3 -1 402 0 3 -1 303 -1 200 -1 200 -1 200 -1 201 -1 200 -1 200 -1 200 -1 200 -1 200 -1 200 -1 301 -1 3 -1 3 -1 306 -1 308 -1 200 -1 200 -1 301 -1 3 -1 401 -1 402 -1 3 -1 3 -1 303 -1 200 -1 200 -1 200 -1 200 -1 200 -1 200 -1 200 -1 200 -1 200 -1 200 -1 200 -1 200 -1 200 -1 200 -1 200 -1 200 -1 200 -1 222 -1 203 -1 242 -1 2 -1 400 1 
401 -1 3 -1 3 -1 306 -1 225 -1 200 -1 200 -1 200 -1 200 -1 200 -1 200 -1 200 -1 200 -1 200 -1 301 -1 3 -1 402 -1 401 -1 303 -1 200 -1 200 -1 310 -1 305 -1 3 -1 3 -1 401 -1 304 -1 309 -1 200 -1 200 -1 200 -1 200 -1 200 -1 200 -1 200 -1 200 -1 201 -1 200 -1 200 -1 200 -1 200 -1 200 -1 200 -1 200 -1 200 -1 200 -1 200 -1 222 -1 300 -1 300 -1 
400 0 401 -1 3 -1 404 0 202 -1 200 -1 200 -1 200 -1 200 -1 200 -1 200 -1 200 -1 200 -1 200 -1 310 -1 300 -1 300 -1 300 -1 309 -1 200 -1 200 -1 200 -1 310 -1 305 -1 3 -1 304 -1 309 -1 200 -1 200 -1 200 -1 200 -1 311 -1 308 -1 200 -1 200 -1 200 -1 200 -1 200 -1 200 -1 200 -1 201 -1 200 -1 200 -1 200 -1 200 -1 200 -1 200 -1 200 -1 200 -1 200 -1 
401 -1 2 -1 403 0 304 -1 223 -1 200 -1 200 -1 200 -1 200 -1 200 -1 200 -1 200 -1 200 -1 200 -1 200 -1 200 -1 200 -1 200 -1 200 -1 200 -1 200 -1 200 -1 311 -1 307 -1 401 -1 303 -1 200 -1 200 -1 200 -1 311 -1 302 -1 307 -1 306 -1 308 -1 200 -1 200 -1 200 -1 200 -1 200 -1 200 -1 200 -1 200 -1 200 -1 200 -1 200 -1 200 -1 200 -1 200 -1 200 -1 200 -1 
3 -1 304 -1 300 -1 309 -1 200 -1 200 -1 200 -1 200 -1 200 -1 200 -1 200 -1 311 -1 302 -1 308 -1 200 -1 200 -1 200 -1 200 -1 200 -1 200 -1 200 -1 200 -1 301 -1 401 -1 401 -1 303 -1 200 -1 200 -1 200 -1 301 -1 3 -1 402 -1 401 -1 303 -1 200 -1 200 -1 200 -1 200 -1 200 -1 200 -1 200 -1 200 -1 200 -1 200 -1 200 -1 200 -1 200 -1 200 -1 200 -1 200 -1 
300 -1 309 -1 200 -1 200 -1 200 -1 200 -1 200 -1 200 -1 200 -1 200 -1 311 -1 307 -1 401 -1 306 -1 302 -1 308 -1 200 -1 200 -1 200 -1 200 -1 200 -1 200 -1 310 -1 300 -1 300 -1 309 -1 200 -1 200 -1 200 -1 301 -1 3 -1 3 -1 304 -1 309 -1 200 -1 200 -1 200 -1 200 -1 200 -1 200 -1 200 -1 200 -1 200 -1 200 -1 200 -1 200 -1 200 -1 201 -1 200 -1 200 -1 
200 -1 200 -1 200 -1 200 -1 200 -1 200 -1 200 -1 200 -1 200 -1 200 -1 301 -1 3 -1 2 -1 4 -1 403 -1 303 -1 200 -1 200 -1 200 -1 200 -1 200 -1 200 -1 200 -1 200 -1 200 -1 200 -1 200 -1 200 -1 200 -1 310 -1 300 -1 300 -1 309 -1 200 -1 200 -1 200 -1 200 -1 200 -1 200 -1 200 -1 200 -1 200 -1 200 -1 200 -1 200 -1 200 -1 200 -1 200 -1 200 -1 200 -1 
200 -1 200 -1 200 -1 200 -1 200 -1 200 -1 200 -1 200 -1 200 -1 200 -1 310 -1 305 -1 3 -1 401 -1 3 -1 303 -1 200 -1 200 -1 201 -1 200 -1 200 -1 200 -1 200 -1 200 -1 200 -1 200 -1 200 -1 200 -1 200 -1 200 -1 200 -1 200 -1 200 -1 200 -1 200 -1 200 -1 200 -1 200 -1 200 -1 200 -1 200 -1 200 -1 311 -1 302 -1 308 -1 200 -1 200 -1 200 -1 200 -1 200 -1 
200 -1 200 -1 200 -1 200 -1 200 -1 201 -1 200 -1 200 -1 200 -1 200 -1 200 -1 310 -1 300 -1 300 -1 300 -1 309 -1 200 -1 200 -1 200 -1 200 -1 200 -1 200 -1 200 -1 311 -1 302 -1 308 -1 200 -1 200 -1 200 -1 200 -1 200 -1 200 -1 200 -1 200 -1 200 -1 200 -1 200 -1 201 -1 200 -1 200 -1 200 -1 311 -1 307 -1 401 -1 306 -1 308 -1 200 -1 200 -1 200 -1 200 -1 
200 -1 200 -1 200 -1 200 -1 200 -1 200 -1 200 -1 200 -1 200 -1 200 -1 200 -1 200 -1 200 -1 200 -1 200 -1 200 -1 200 -1 200 -1 200 -1 200 -1 200 -1 200 -1 311 -1 307 -1 401 -1 306 -1 308 -1 200 -1 200 -1 200 -1 200 -1 200 -1 200 -1 200 -1 200 -1 200 -1 200 -1 200 -1 200 -1 200 -1 200 -1 301 -1 403 -1 2 -1 3 -1 303 -1 200 -1 200 -1 200 -1 200 -1 
201 -1 200 -1 200 -1 200 -1 200 -1 200 -1 200 -1 200 -1 200 -1 200 -1 200 -1 200 -1 200 -1 200 -1 200 -1 200 -1 200 -1 200 -1 200 -1 200 -1 200 -1 200 -1 301 -1 401 -1 2 -1 401 -1 303 -1 200 -1 200 -1 200 -1 201 -1 200 -1 200 -1 200 -1 200 -1 200 -1 200 -1 200 -1 200 -1 200 -1 200 -1 310 -1 305 -1 3 -1 401 -1 303 -1 200 -1 200 -1 200 -1 200 -1 
-1
