40
40
3
200 -1 200 -1 200 -1 200 -1 200 -1 200 -1 200 -1 200 -1 200 -1 200 -1 200 -1 200 -1 200 -1 200 -1 200 -1 200 -1 200 -1 200 -1 204 -1 4 -1 3 -1 3 -1 401 -1 3 -1 3 -1 3 -1 3 -1 3 -1 303 -1 200 -1 200 -1 200 -1 200 -1 200 -1 200 -1 204 -1 4 -1 3 -1 3 -1 3 -1 
200 -1 200 -1 200 -1 200 -1 200 -1 200 -1 200 -1 200 -1 200 -1 200 -1 200 -1 200 -1 200 -1 200 -1 200 -1 200 -1 200 -1 200 -1 204 -1 4 -1 3 -1 3 -1 3 -1 3 -1 3 -1 3 -1 3 -1 3 -1 306 -1 302 -1 308 -1 200 -1 200 -1 200 -1 200 -1 204 -1 4 -1 3 -1 403 -1 3 -1 
200 -1 200 -1 200 -1 200 -1 200 -1 200 -1 200 -1 200 -1 200 -1 200 -1 200 -1 200 -1 200 -1 200 -1 200 -1 200 -1 200 -1 200 -1 204 -1 4 -1 3 -1 3 -1 3 -1 3 -1 3 -1 3 -1 3 -1 401 -1 3 -1 304 -1 309 -1 200 -1 200 -1 200 -1 200 -1 204 -1 4 -1 4 -1 4 -1 4 -1 
200 -1 200 -1 200 -1 200 -1 200 -1 200 -1 200 -1 200 -1 200 -1 200 -1 200 -1 200 -1 200 -1 200 -1 200 -1 200 -1 200 -1 200 -1 204 -1 4 -1 3 -1 3 -1 3 -1 3 -1 3 -1 3 -1 3 -1 401 -1 3 -1 303 -1 200 -1 200 -1 200 -1 200 -1 200 -1 222 -1 203 -1 203 -1 203 -1 203 -1 
200 -1 200 -1 200 -1 200 -1 200 -1 200 -1 200 -1 200 -1 200 -1 200 -1 200 -1 200 -1 200 -1 200 -1 200 -1 200 -1 200 -1 200 -1 204 -1 4 -1 3 -1 401 -1 401 -1 3 -1 3 -1 3 -1 3 -1 3 -1 3 -1 303 -1 200 -1 200 -1 200 -1 200 -1 200 -1 200 -1 200 -1 200 -1 200 -1 200 -1 
205 -1 205 -1 205 -1 205 -1 205 -1 205 -1 205 -1 205 -1 205 -1 225 -1 225 -1 200 -1 200 -1 200 -1 200 -1 200 -1 200 -1 200 -1 204 -1 4 -1 3 -1 3 -1 304 -1 300 -1 300 -1 300 -1 305 -1 3 -1 3 -1 303 -1 200 -1 200 -1 200 -1 200 -1 200 -1 200 -1 200 -1 200 -1 200 -1 200 -1 
4 -1 4 -1 4 -1 4 -1 4 -1 4 -1 4 -1 4 -1 4 -1 317 -1 200 -1 200 -1 200 -1 200 -1 200 -1 200 -1 200 -1 200 -1 204 -1 4 -1 3 -1 304 -1 309 -1 200 -1 200 -1 200 -1 310 -1 305 -1 3 -1 303 -1 200 -1 200 -1 200 -1 200 -1 200 -1 200 -1 200 -1 200 -1 200 -1 200 -1 
3 -1 3 -1 401 -1 401 -1 3 -1 3 -1 3 -1 3 -1 3 -1 303 -1 200 -1 200 -1 200 -1 200 -1 200 -1 200 -1 200 -1 200 -1 200 -1 322 -1 300 -1 309 -1 200 -1 200 -1 200 -1 200 -1 200 -1 319 -1 404 -1 321 -1 200 -1 200 -1 200 -1 200 -1 200 -1 200 -1 200 -1 200 -1 200 -1 200 -1 
3 -1 3 -1 3 -1 401 -1 3 -1 3 -1 304 -1 300 -1 300 -1 309 -1 200 -1 200 -1 200 -1 200 -1 200 -1 200 -1 200 -1 200 -1 200 -1 200 -1 200 -1 200 -1 200 -1 200 -1 200 -1 200 -1 200 -1 222 -1 203 -1 223 -1 200 -1 200 -1 200 -1 200 -1 200 -1 200 -1 200 -1 200 -1 200 -1 200 -1 
3 -1 3 -1 3 -1 3 -1 3 -1 3 -1 303 -1 200 -1 200 -1 200 -1 200 -1 200 -1 200 -1 200 -1 200 -1 200 -1 200 -1 200 -1 200 -1 200 -1 200 -1 200 -1 200 -1 200 -1 200 -1 200 -1 200 -1 200 -1 200 -1 200 -1 200 -1 200 -1 200 -1 200 -1 200 -1 200 -1 200 -1 200 -1 200 -1 200 -1 
3 -1 3 -1 3 -1 3 -1 401 -1 3 -1 303 -1 200 -1 200 -1 200 -1 200 -1 200 -1 200 -1 200 -1 200 -1 200 -1 200 -1 200 -1 200 -1 200 -1 200 -1 200 -1 200 -1 200 -1 200 -1 200 -1 200 -1 200 -1 200 -1 200 -1 200 -1 200 -1 200 -1 224 -1 205 -1 205 -1 205 -1 205 -1 205 -1 205 -1 
300 -1 300 -1 300 -1 305 -1 3 -1 3 -1 306 -1 302 -1 308 -1 200 -1 200 -1 200 -1 200 -1 200 -1 224 -1 205 -1 205 -1 225 -1 200 -1 200 -1 200 -1 200 -1 200 -1 200 -1 200 -1 200 -1 200 -1 200 -1 200 -1 200 -1 200 -1 200 -1 200 -1 204 -1 4 -1 4 -1 4 -1 4 -1 4 -1 4 -1 
200 -1 200 -1 200 -1 301 -1 3 -1 3 -1 3 -1 3 -1 306 -1 308 -1 200 -1 200 -1 200 -1 200 -1 204 -1 4 -1 404 -1 317 -1 200 -1 200 -1 200 -1 200 -1 311 -1 302 -1 308 -1 200 -1 200 -1 200 -1 200 -1 200 -1 200 -1 200 -1 200 -1 204 -1 4 -1 3 -1 3 -1 3 -1 3 -1 3 -1 
200 -1 200 -1 200 -1 310 -1 300 -1 404 -1 300 -1 300 -1 300 -1 309 -1 200 -1 200 -1 200 -1 200 -1 204 -1 4 -1 3 -1 303 -1 200 -1 200 -1 311 -1 308 -1 301 -1 3 -1 303 -1 200 -1 200 -1 200 -1 200 -1 200 -1 200 -1 200 -1 200 -1 204 -1 4 -1 3 -1 3 -1 3 -1 3 -1 401 -1 
200 -1 200 -1 200 -1 200 -1 200 -1 200 -1 200 -1 200 -1 200 -1 200 -1 200 -1 200 -1 200 -1 200 -1 204 -1 4 -1 3 -1 306 -1 302 -1 302 -1 307 -1 306 -1 307 -1 3 -1 306 -1 302 -1 308 -1 200 -1 200 -1 200 -1 200 -1 200 -1 200 -1 204 -1 4 -1 3 -1 3 -1 3 -1 3 -1 3 -1 
200 -1 200 -1 200 -1 200 -1 200 -1 200 -1 200 -1 200 -1 200 -1 200 -1 200 -1 200 -1 200 -1 200 -1 204 -1 4 -1 3 -1 3 -1 3 -1 3 -1 401 0 401 0 401 0 3 -1 304 -1 300 -1 309 -1 200 -1 200 -1 200 -1 200 -1 200 -1 200 -1 204 -1 4 -1 3 -1 401 -1 3 -1 3 -1 3 -1 
200 -1 200 -1 200 -1 200 -1 200 -1 200 -1 200 -1 200 -1 200 -1 200 -1 200 -1 200 -1 200 -1 200 -1 204 -1 4 -1 401 0 3 -1 3 -1 3 -1 3 -1 3 -1 3 -1 3 -1 306 -1 302 -1 302 -1 308 -1 200 -1 200 -1 200 -1 200 -1 200 -1 204 -1 4 -1 3 -1 401 -1 3 -1 3 -1 3 -1 
200 -1 311 -1 302 -1 302 -1 308 -1 200 -1 200 -1 200 -1 200 -1 200 -1 200 -1 200 -1 200 -1 200 -1 204 -1 4 -1 401 0 3 -1 3 -1 400 0 3 -1 3 -1 402 0 3 -1 304 -1 300 -1 300 -1 309 -1 200 -1 200 -1 200 -1 200 -1 200 -1 204 -1 4 -1 3 -1 3 -1 3 -1 3 -1 3 -1 
200 -1 301 -1 3 -1 3 -1 303 -1 200 -1 200 -1 200 -1 200 -1 200 -1 200 -1 200 -1 200 -1 200 -1 204 -1 4 -1 3 -1 3 -1 3 -1 3 -1 3 -1 3 -1 3 -1 3 -1 303 -1 200 -1 200 -1 200 -1 200 -1 200 -1 200 -1 200 -1 200 -1 204 -1 4 -1 3 -1 3 -1 3 -1 3 -1 3 -1 
200 -1 301 -1 3 -1 3 -1 321 -1 200 -1 200 -1 200 -1 200 -1 200 -1 200 -1 200 -1 200 -1 200 -1 204 -1 4 -1 3 -1 3 -1 3 -1 3 -1 3 -1 401 0 3 -1 3 -1 303 -1 200 -1 201 -1 200 -1 200 -1 200 -1 200 -1 200 -1 200 -1 204 -1 4 -1 3 -1 3 -1 3 -1 3 -1 3 -1 
302 -1 307 -1 3 -1 3 -1 214 -1 205 -1 200 -1 200 -1 200 -1 200 -1 200 -1 200 -1 200 -1 200 -1 204 -1 4 -1 3 -1 3 -1 3 -1 304 -1 300 -1 300 -1 305 -1 3 -1 303 -1 200 -1 200 -1 200 -1 200 -1 200 -1 200 -1 200 -1 200 -1 200 -1 208 -1 404 -1 300 -1 305 -1 3 -1 401 -1 
403 -1 3 -1 3 -1 3 -1 3 -1 404 -1 202 -1 200 -1 200 -1 200 -1 200 -1 200 -1 200 -1 200 -1 222 -1 322 -1 300 -1 300 -1 305 -1 303 -1 200 -1 200 -1 310 -1 300 -1 309 -1 200 -1 200 -1 200 -1 200 -1 200 -1 200 -1 200 -1 200 -1 200 -1 200 -1 203 -1 200 -1 310 -1 305 -1 3 -1 
3 -1 3 -1 3 -1 3 -1 3 -1 216 -1 316 -1 302 -1 308 -1 200 -1 200 -1 200 -1 200 -1 200 -1 200 -1 200 -1 200 -1 200 -1 301 -1 303 -1 200 -1 200 -1 200 -1 200 -1 200 -1 200 -1 200 -1 200 -1 200 -1 200 -1 200 -1 200 -1 200 -1 200 -1 200 -1 200 -1 200 -1 200 -1 310 -1 300 -1 
3 -1 3 -1 401 -1 3 -1 304 -1 300 -1 300 -1 300 -1 309 -1 200 -1 200 -1 200 -1 200 -1 200 -1 200 -1 200 -1 200 -1 200 -1 310 -1 309 -1 200 -1 200 -1 200 -1 200 -1 200 -1 200 -1 200 -1 200 -1 200 -1 200 -1 200 -1 200 -1 200 -1 200 -1 200 -1 200 -1 200 -1 200 -1 201 -1 200 -1 
3 -1 3 -1 401 -1 3 -1 303 -1 200 -1 200 -1 200 -1 200 -1 200 -1 200 -1 200 -1 200 -1 200 -1 200 -1 200 -1 200 -1 200 -1 200 -1 200 -1 200 -1 200 -1 200 -1 200 -1 200 -1 200 -1 200 -1 200 -1 311 -1 302 -1 308 -1 200 -1 200 -1 200 -1 200 -1 200 -1 200 -1 200 -1 200 -1 200 -1 
3 -1 3 -1 3 -1 3 -1 303 -1 225 -1 200 -1 200 -1 200 -1 200 -1 200 -1 200 -1 200 -1 200 -1 200 -1 200 -1 200 -1 200 -1 200 -1 200 -1 200 -1 200 -1 200 -1 200 -1 200 -1 200 -1 200 -1 311 -1 307 -1 3 -1 306 -1 308 -1 200 -1 200 -1 200 -1 200 -1 200 -1 200 -1 200 -1 200 -1 
4 -1 4 -1 4 -1 4 -1 4 -1 202 -1 200 -1 200 -1 200 -1 200 -1 200 -1 200 -1 200 -1 200 -1 200 -1 200 -1 200 -1 200 -1 200 -1 200 -1 200 -1 200 -1 224 -1 205 -1 316 -1 302 -1 302 -1 307 -1 3 -1 3 -1 3 -1 306 -1 302 -1 302 -1 308 -1 200 -1 200 -1 200 -1 200 -1 200 -1 
203 -1 203 -1 203 -1 203 -1 203 -1 200 -1 200 -1 200 -1 200 -1 200 -1 200 -1 200 -1 200 -1 200 -1 200 -1 200 -1 200 -1 200 -1 200 -1 200 -1 200 -1 200 -1 204 -1 4 -1 3 -1 3 -1 3 -1 3 -1 3 -1 3 -1 401 2 401 2 3 -1 304 -1 309 -1 200 -1 200 -1 200 -1 200 -1 200 -1 
200 -1 200 -1 200 -1 200 -1 200 -1 200 -1 200 -1 200 -1 224 -1 205 -1 205 -1 205 -1 205 -1 205 -1 205 -1 205 -1 205 -1 205 -1 205 -1 205 -1 205 -1 225 -1 204 -1 4 -1 3 -1 3 -1 3 -1 3 -1 3 -1 3 -1 3 -1 304 -1 300 -1 309 -1 200 -1 200 -1 200 -1 200 -1 200 -1 200 -1 
200 -1 200 -1 200 -1 200 -1 200 -1 200 -1 200 -1 200 -1 204 -1 4 -1 4 -1 4 -1 4 -1 4 -1 4 -1 4 -1 4 -1 4 -1 4 -1 4 -1 4 -1 202 -1 204 -1 4 -1 401 2 3 -1 3 -1 402 2 3 -1 3 -1 3 -1 303 -1 200 -1 200 -1 200 -1 200 -1 200 -1 200 -1 200 -1 200 -1 
200 -1 200 -1 200 -1 200 -1 224 -1 205 -1 200 -1 200 -1 323 -1 3 -1 3 -1 3 -1 3 -1 3 -1 3 -1 3 -1 3 -1 3 -1 3 -1 4 -1 4 -1 202 -1 204 -1 4 -1 401 2 3 -1 3 -1 3 -1 3 -1 400 2 3 -1 303 -1 200 -1 200 -1 224 -1 205 -1 225 -1 200 -1 200 -1 200 -1 
200 -1 200 -1 200 -1 200 -1 204 -1 404 -1 302 -1 302 -1 307 -1 3 -1 401 1 401 1 3 -1 3 -1 3 -1 402 1 3 -1 3 -1 3 -1 3 -1 4 -1 202 -1 204 -1 4 -1 3 -1 3 -1 3 -1 3 -1 3 -1 3 -1 3 -1 306 -1 308 -1 200 -1 204 -1 404 -1 202 -1 200 -1 200 -1 200 -1 
200 -1 200 -1 200 -1 200 -1 222 -1 203 -1 322 -1 305 -1 3 -1 3 -1 3 -1 3 -1 3 -1 3 -1 3 -1 3 -1 3 -1 401 1 3 -1 3 -1 4 -1 202 -1 204 -1 4 -1 3 -1 3 -1 401 2 401 2 3 -1 3 -1 3 -1 3 -1 306 -1 320 -1 212 -1 3 -1 317 -1 200 -1 200 -1 200 -1 
317 -1 200 -1 200 -1 200 -1 200 -1 200 -1 200 -1 310 -1 305 -1 3 -1 3 -1 3 -1 3 -1 400 1 3 -1 3 -1 3 -1 401 1 3 -1 3 -1 4 -1 202 -1 204 -1 4 -1 4 -1 3 -1 3 -1 3 -1 3 -1 3 -1 3 -1 3 -1 3 -1 3 -1 3 -1 304 -1 309 -1 200 -1 200 -1 200 -1 
303 -1 200 -1 200 -1 200 -1 200 -1 200 -1 200 -1 200 -1 301 -1 3 -1 3 -1 3 -1 3 -1 3 -1 3 -1 304 -1 300 -1 305 -1 3 -1 3 -1 4 -1 202 -1 204 -1 4 -1 4 -1 4 -1 4 -1 4 -1 4 -1 4 -1 4 -1 4 -1 4 -1 211 -1 322 -1 309 -1 200 -1 200 -1 200 -1 200 -1 
306 -1 308 -1 200 -1 200 -1 200 -1 200 -1 200 -1 200 -1 301 -1 3 -1 401 1 401 1 3 -1 3 -1 304 -1 309 -1 200 -1 310 -1 305 -1 3 -1 4 -1 202 -1 222 -1 203 -1 203 -1 203 -1 203 -1 203 -1 203 -1 203 -1 203 -1 203 -1 203 -1 223 -1 200 -1 200 -1 200 -1 200 -1 200 -1 200 -1 
401 -1 306 -1 308 -1 200 -1 200 -1 200 -1 200 -1 200 -1 310 -1 300 -1 300 -1 300 -1 300 -1 305 -1 303 -1 200 -1 200 -1 200 -1 310 -1 318 -1 203 -1 223 -1 200 -1 200 -1 200 -1 200 -1 200 -1 200 -1 200 -1 200 -1 200 -1 200 -1 200 -1 200 -1 200 -1 200 -1 200 -1 311 -1 302 -1 302 -1 
401 -1 402 -1 306 -1 308 -1 200 -1 200 -1 200 -1 200 -1 200 -1 200 -1 200 -1 200 -1 200 -1 310 -1 309 -1 200 -1 200 -1 200 -1 200 -1 200 -1 200 -1 200 -1 200 -1 200 -1 200 -1 200 -1 200 -1 200 -1 200 -1 200 -1 200 -1 200 -1 200 -1 200 -1 200 -1 200 -1 200 -1 301 -1 3 -1 401 -1 
304 -1 300 -1 300 -1 309 -1 200 -1 200 -1 200 -1 200 -1 200 -1 200 -1 200 -1 200 -1 200 -1 200 -1 200 -1 200 -1 200 -1 200 -1 200 -1 200 -1 200 -1 200 -1 200 -1 200 -1 200 -1 200 -1 200 -1 200 -1 200 -1 200 -1 200 -1 200 -1 200 -1 200 -1 200 -1 200 -1 200 -1 301 -1 403 -1 3 -1 
303 -1 200 -1 200 -1 200 -1 200 -1 200 -1 200 -1 200 -1 200 -1 200 -1 200 -1 200 -1 200 -1 200 -1 200 -1 200 -1 200 -1 200 -1 200 -1 200 -1 200 -1 200 -1 200 -1 200 -1 200 -1 200 -1 200 -1 200 -1 200 -1 200 -1 200 -1 200 -1 200 -1 200 -1 200 -1 200 -1 311 -1 307 -1 3 -1 401 -1 
-1
