35
20
3
2 -1 2 -1 4 -1 4 -1 4 -1 3 -1 3 -1 3 -1 3 -1 3 -1 3 -1 3 -1 3 -1 401 1 3 -1 400 1 3 -1 3 -1 3 -1 3 -1 3 -1 4 -1 4 -1 4 -1 3 -1 3 -1 3 -1 3 -1 6 -1 3 -1 3 -1 401 -1 3 -1 3 -1 3 -1 
2 -1 2 -1 4 -1 4 -1 4 -1 3 -1 3 -1 3 -1 3 -1 3 -1 3 -1 2 -1 2 -1 3 -1 3 -1 6 -1 3 -1 3 -1 3 -1 3 -1 3 -1 3 -1 3 -1 3 -1 402 -1 3 -1 3 -1 3 -1 6 -1 3 -1 3 -1 3 -1 3 -1 3 -1 3 -1 
2 -1 2 -1 2 -1 4 -1 4 -1 3 -1 3 -1 3 -1 3 -1 3 -1 2 -1 2 -1 2 -1 3 -1 3 -1 6 -1 3 -1 401 -1 3 -1 3 -1 3 -1 3 -1 3 -1 3 -1 3 -1 3 -1 3 -1 3 -1 6 -1 3 -1 3 -1 3 -1 3 -1 3 -1 3 -1 
3 -1 2 -1 2 -1 4 -1 4 -1 3 -1 3 -1 3 -1 3 -1 3 -1 3 -1 3 -1 2 -1 2 -1 3 -1 6 -1 2 -1 3 -1 3 -1 3 -1 3 -1 3 -1 3 -1 4 -1 3 -1 4 -1 2 -1 3 -1 6 -1 3 -1 3 -1 2 -1 3 -1 2 -1 2 -1 
3 -1 3 -1 4 -1 4 -1 4 -1 4 -1 3 -1 3 -1 3 -1 3 -1 3 -1 3 -1 402 1 2 -1 2 -1 6 -1 3 -1 3 -1 3 -1 3 -1 3 -1 4 -1 4 -1 4 -1 4 -1 4 -1 2 -1 3 -1 6 -1 3 -1 2 -1 2 -1 402 2 3 -1 2 -1 
3 -1 3 -1 3 -1 4 -1 4 -1 4 -1 3 -1 3 -1 3 -1 3 -1 3 -1 3 -1 3 -1 2 -1 9 -1 12 -1 16 -1 5 -1 5 -1 5 -1 10 -1 401 -1 4 -1 4 -1 4 -1 2 -1 2 -1 401 -1 6 -1 3 -1 2 -1 3 -1 3 -1 2 -1 2 -1 
401 0 3 -1 3 -1 3 -1 4 -1 4 -1 401 -1 3 -1 3 -1 3 -1 3 -1 3 -1 3 -1 3 -1 6 -1 3 -1 3 -1 4 -1 3 -1 3 -1 6 -1 3 -1 4 -1 4 -1 4 -1 4 -1 2 -1 4 -1 6 -1 3 -1 3 -1 3 -1 3 -1 2 -1 2 -1 
3 -1 400 0 3 -1 3 -1 3 -1 4 -1 4 -1 4 -1 3 -1 3 -1 3 -1 2 -1 3 -1 3 -1 6 -1 3 -1 4 -1 4 -1 4 -1 3 -1 17 -1 3 -1 3 -1 4 -1 4 -1 4 -1 4 -1 4 -1 6 -1 3 -1 3 -1 3 -1 2 -1 2 -1 2 -1 
3 -1 6 -1 3 -1 3 -1 3 -1 4 -1 4 -1 4 -1 3 -1 3 -1 3 -1 3 -1 3 -1 3 -1 18 -1 3 -1 4 -1 4 -1 4 -1 3 -1 6 -1 3 -1 3 -1 3 -1 4 -1 4 -1 3 -1 3 -1 6 -1 3 -1 3 -1 3 -1 400 2 2 -1 3 -1 
3 -1 7 -1 5 -1 13 -1 5 -1 10 -1 4 -1 4 -1 4 -1 3 -1 3 -1 3 -1 3 -1 3 -1 6 -1 4 -1 4 -1 4 -1 401 -1 3 -1 7 -1 13 -1 5 -1 5 -1 5 -1 5 -1 5 -1 16 -1 12 -1 5 -1 5 -1 5 -1 8 -1 3 -1 3 -1 
3 -1 3 -1 3 -1 6 -1 401 -1 7 -1 5 -1 5 -1 5 -1 5 -1 5 -1 16 -1 5 -1 5 -1 12 -1 10 -1 4 -1 4 -1 4 -1 3 -1 3 -1 18 -1 3 -1 3 -1 3 -1 3 -1 3 -1 3 -1 3 -1 3 -1 4 -1 4 -1 3 -1 3 -1 401 2 
3 -1 2 -1 2 -1 6 -1 2 -1 3 -1 3 -1 3 -1 3 -1 3 -1 3 -1 3 -1 3 -1 401 -1 3 -1 7 -1 10 -1 3 -1 4 -1 402 -1 3 -1 6 -1 3 -1 3 -1 3 -1 3 -1 3 -1 3 -1 4 -1 4 -1 4 -1 4 -1 3 -1 3 -1 3 -1 
3 -1 3 -1 402 0 6 -1 3 -1 3 -1 3 -1 3 -1 3 -1 2 -1 2 -1 2 -1 4 -1 4 -1 4 -1 3 -1 17 -1 3 -1 3 -1 3 -1 9 -1 8 -1 3 -1 401 -1 4 -1 4 -1 4 -1 4 -1 4 -1 4 -1 4 -1 4 -1 2 -1 3 -1 3 -1 
3 -1 2 -1 2 -1 6 -1 3 -1 3 -1 3 -1 3 -1 2 -1 2 -1 2 -1 4 -1 4 -1 4 -1 4 -1 3 -1 7 -1 13 -1 5 -1 16 -1 8 -1 4 -1 4 -1 4 -1 4 -1 4 -1 4 -1 4 -1 4 -1 4 -1 2 -1 2 -1 2 -1 401 -1 3 -1 
3 -1 2 -1 2 -1 6 -1 2 -1 3 -1 3 -1 3 -1 3 -1 2 -1 4 -1 4 -1 4 -1 4 -1 2 -1 3 -1 3 -1 6 -1 3 -1 3 -1 4 -1 4 -1 4 -1 4 -1 4 -1 2 -1 4 -1 4 -1 4 -1 4 -1 2 -1 2 -1 2 -1 2 -1 2 -1 
2 -1 2 -1 3 -1 6 -1 401 -1 3 -1 3 -1 3 -1 3 -1 402 -1 4 -1 4 -1 4 -1 4 -1 2 -1 2 -1 3 -1 6 -1 3 -1 4 -1 4 -1 4 -1 4 -1 4 -1 4 -1 4 -1 4 -1 4 -1 4 -1 4 -1 2 -1 2 -1 2 -1 2 -1 2 -1 
2 -1 2 -1 2 -1 6 -1 3 -1 3 -1 3 -1 3 -1 3 -1 3 -1 4 -1 4 -1 4 -1 2 -1 2 -1 2 -1 3 -1 18 -1 3 -1 4 -1 4 -1 4 -1 4 -1 4 -1 4 -1 4 -1 4 -1 4 -1 4 -1 2 -1 2 -1 4 -1 2 -1 2 -1 2 -1 
2 -1 2 -1 2 -1 17 -1 3 -1 3 -1 3 -1 3 -1 2 -1 4 -1 4 -1 4 -1 4 -1 2 -1 2 -1 2 -1 3 -1 6 -1 3 -1 401 -1 4 -1 4 -1 4 -1 3 -1 3 -1 3 -1 4 -1 4 -1 2 -1 2 -1 4 -1 4 -1 4 -1 4 -1 2 -1 
3 -1 3 -1 3 -1 6 -1 3 -1 3 -1 3 -1 2 -1 2 -1 2 -1 2 -1 2 -1 2 -1 2 -1 2 -1 3 -1 3 -1 6 -1 3 -1 3 -1 3 -1 3 -1 3 -1 3 -1 3 -1 3 -1 2 -1 2 -1 2 -1 4 -1 4 -1 4 -1 4 -1 4 -1 4 -1 
3 -1 3 -1 3 -1 6 -1 3 -1 3 -1 3 -1 2 -1 2 -1 2 -1 2 -1 2 -1 2 -1 2 -1 2 -1 3 -1 3 -1 6 -1 403 -1 3 -1 3 -1 3 -1 3 -1 3 -1 3 -1 2 -1 2 -1 2 -1 2 -1 401 -1 4 -1 4 -1 4 -1 4 -1 4 -1 
-1
