21
21
2
401 -1 600 -1 3 -1 401 -1 3 -1 105 -1 3 -1 3 -1 3 -1 2 -1 2 -1 2 -1 3 -1 3 -1 3 -1 3 -1 3 -1 101 -1 103 -1 103 -1 108 0 
2 -1 3 -1 3 -1 2 -1 401 -1 105 -1 3 -1 401 -1 3 -1 3 -1 3 -1 2 -1 2 -1 2 -1 3 -1 3 -1 3 -1 3 -1 3 -1 3 -1 105 -1 
401 -1 401 -1 3 -1 403 -1 2 -1 105 -1 3 -1 3 -1 3 -1 3 -1 3 -1 3 -1 3 -1 3 -1 3 -1 3 -1 3 -1 3 -1 402 0 3 -1 101 -1 
3 -1 3 -1 2 -1 401 -1 2 -1 105 -1 3 -1 3 -1 2 -1 2 -1 3 -1 3 -1 3 -1 9 -1 5 -1 5 -1 5 -1 5 -1 5 -1 5 -1 5 -1 
401 -1 3 -1 109 -1 103 -1 6 -1 106 -1 108 -1 3 -1 3 -1 2 -1 3 -1 3 -1 3 -1 6 -1 3 -1 3 -1 3 -1 3 -1 3 -1 3 -1 3 -1 
103 -1 103 -1 107 -1 401 -1 3 -1 401 -1 105 -1 3 -1 3 -1 3 -1 3 -1 3 -1 3 -1 6 -1 3 -1 3 -1 3 -1 3 -1 3 -1 3 -1 3 -1 
3 -1 3 -1 105 -1 401 -1 401 -1 401 -1 105 -1 3 -1 3 -1 401 1 3 -1 3 -1 3 -1 6 -1 3 -1 401 0 3 -1 3 -1 3 -1 3 -1 3 -1 
3 -1 2 -1 101 -1 103 -1 103 -1 103 -1 100 -1 2 -1 2 -1 3 -1 3 -1 3 -1 3 -1 6 -1 3 -1 3 -1 402 -1 3 -1 3 -1 3 -1 3 -1 
3 -1 2 -1 2 -1 3 -1 3 -1 3 -1 3 -1 2 -1 2 -1 3 -1 3 -1 3 -1 3 -1 6 -1 3 -1 3 -1 3 -1 3 -1 3 -1 3 -1 3 -1 
3 -1 3 -1 2 -1 3 -1 401 1 3 -1 3 -1 9 -1 5 -1 5 -1 5 -1 5 -1 5 -1 14 -1 3 -1 3 -1 3 -1 3 -1 2 -1 3 -1 2 -1 
3 -1 3 -1 3 -1 2 -1 3 -1 3 -1 3 -1 6 -1 400 1 4 -1 600 -1 4 -1 400 0 6 -1 3 -1 3 -1 3 -1 3 -1 2 -1 2 -1 2 -1 
3 -1 3 -1 3 -1 3 -1 3 -1 3 -1 3 -1 11 -1 5 -1 5 -1 5 -1 5 -1 5 -1 8 -1 3 -1 3 -1 3 -1 3 -1 3 -1 2 -1 2 -1 
3 -1 401 -1 3 -1 3 -1 2 -1 3 -1 3 -1 6 -1 2 -1 2 -1 2 -1 2 -1 2 -1 3 -1 3 -1 3 -1 401 0 3 -1 3 -1 3 -1 3 -1 
3 -1 3 -1 3 -1 3 -1 3 -1 402 -1 3 1 6 -1 3 -1 2 -1 2 -1 2 -1 3 -1 3 -1 3 -1 3 -1 3 -1 3 -1 3 -1 3 -1 401 -1 
3 -1 3 -1 2 -1 2 -1 2 -1 3 -1 3 -1 6 -1 3 -1 3 -1 3 -1 3 -1 2 -1 2 -1 3 -1 2 -1 2 -1 3 -1 3 -1 2 -1 3 -1 
3 -1 2 -1 2 -1 3 -1 2 -1 3 -1 3 -1 6 -1 3 -1 3 -1 3 -1 401 -1 3 -1 3 -1 3 -1 2 -1 2 -1 3 -1 2 -1 2 -1 2 -1 
3 -1 3 -1 3 -1 3 -1 3 -1 3 -1 3 -1 6 -1 3 -1 3 -1 3 -1 3 -1 4 -1 4 -1 3 -1 4 -1 4 -1 4 -1 4 -1 3 -1 4 -1 
5 -1 5 -1 5 -1 5 -1 5 -1 5 -1 5 -1 8 -1 3 -1 3 -1 3 -1 3 -1 4 -1 3 -1 3 -1 3 -1 4 -1 4 -1 3 -1 3 -1 3 -1 
108 -1 3 -1 402 1 3 -1 3 -1 3 -1 3 -1 3 -1 2 -1 3 -1 3 -1 3 -1 4 -1 3 -1 3 -1 3 -1 4 -1 4 -1 3 -1 3 -1 3 -1 
105 -1 3 -1 3 -1 3 -1 3 -1 3 -1 3 -1 3 -1 3 -1 3 -1 3 -1 3 -1 4 -1 3 -1 3 -1 3 -1 4 -1 4 -1 3 -1 3 -1 3 -1 
101 1 103 -1 103 -1 108 -1 3 -1 3 -1 3 -1 2 -1 2 -1 3 -1 3 -1 401 -1 4 -1 4 -1 4 -1 4 -1 4 -1 4 -1 4 -1 4 -1 4 -1 
18
19
7
0
19
19
12
0
20
19
7
0
20
18
20
0
18
18
7
0
15
19
7
1
14
19
12
1
14
18
7
1
19
17
20
0
19
18
7
0
15
17
20
1
15
18
7
1
14
17
20
1
13
18
20
1
13
19
7
1
-1
