20
18
2
3 -1 401 -1 3 -1 3 -1 4 -1 4 -1 400 0 3 -1 4 -1 3 -1 3 -1 3 -1 4 -1 4 -1 402 1 4 -1 4 -1 401 -1 3 -1 3 -1 
3 -1 3 -1 3 -1 3 -1 3 0 4 -1 6 -1 4 -1 3 0 3 -1 3 -1 3 -1 3 -1 4 -1 6 -1 4 -1 3 -1 3 -1 3 -1 3 -1 
3 -1 402 -1 3 -1 3 -1 401 0 4 -1 6 -1 4 -1 401 0 3 -1 402 -1 3 -1 2 -1 4 -1 6 -1 4 -1 3 -1 9 -1 402 -1 3 -1 
3 -1 6 -1 3 -1 3 -1 4 -1 4 -1 6 -1 4 -1 4 -1 3 -1 3 -1 3 -1 4 -1 4 -1 6 -1 4 -1 4 -1 6 -1 2 -1 3 -1 
4 -1 6 -1 3 -1 4 -1 4 -1 4 -1 401 -1 4 -1 4 -1 4 -1 3 -1 4 -1 4 -1 4 -1 6 -1 4 -1 4 -1 6 -1 4 -1 4 -1 
4 -1 6 -1 4 -1 4 -1 4 -1 4 -1 6 -1 4 -1 4 -1 4 -1 2 -1 4 -1 4 -1 4 -1 6 -1 4 -1 4 -1 6 -1 4 -1 4 -1 
3 -1 11 -1 5 -1 401 -1 5 -1 5 -1 15 -1 5 -1 16 -1 3 -1 2 -1 19 -1 5 -1 5 -1 401 -1 5 -1 5 -1 14 -1 401 -1 3 -1 
4 -1 6 -1 4 -1 4 -1 4 -1 4 -1 6 -1 4 -1 4 -1 4 -1 2 -1 4 -1 4 -1 4 -1 6 -1 4 -1 4 -1 6 -1 4 -1 4 -1 
4 -1 6 -1 401 -1 4 -1 4 -1 4 -1 6 -1 4 -1 4 -1 4 -1 3 -1 4 -1 4 -1 4 -1 6 -1 4 -1 4 -1 6 -1 4 -1 4 -1 
3 -1 6 -1 3 -1 3 -1 4 -1 4 -1 6 -1 4 -1 4 -1 3 -1 3 -1 3 -1 4 -1 4 -1 6 -1 4 -1 4 -1 6 -1 3 -1 2 -1 
3 -1 6 -1 2 -1 2 -1 3 -1 4 -1 6 -1 4 -1 3 -1 402 -1 2 -1 3 -1 401 1 4 -1 401 -1 4 -1 401 1 6 -1 3 -1 3 -1 
401 -1 6 -1 2 -1 3 -1 3 -1 4 -1 401 -1 4 -1 3 -1 2 -1 3 -1 3 -1 3 1 4 -1 6 -1 4 -1 3 1 7 -1 402 -1 3 -1 
3 -1 7 -1 402 -1 3 -1 4 -1 4 -1 6 -1 4 -1 4 -1 3 -1 2 -1 3 -1 4 -1 4 -1 6 -1 4 -1 4 -1 3 -1 3 -1 3 -1 
4 -1 3 -1 3 -1 4 -1 4 -1 4 -1 6 -1 4 -1 4 -1 4 -1 3 -1 4 -1 4 -1 4 -1 6 -1 4 -1 4 -1 3 -1 3 -1 4 -1 
4 -1 4 -1 4 -1 4 -1 4 -1 4 -1 402 0 4 -1 4 -1 4 -1 4 -1 4 -1 4 -1 4 -1 400 1 3 -1 4 -1 4 -1 4 -1 4 -1 
3 -1 3 -1 3 -1 3 -1 3 -1 3 -1 3 -1 3 -1 3 -1 3 -1 3 -1 3 -1 3 -1 3 -1 3 -1 3 -1 3 -1 3 -1 3 -1 3 -1 
3 -1 3 -1 3 -1 3 -1 3 -1 3 -1 3 -1 3 -1 3 -1 3 -1 3 -1 3 -1 3 -1 3 -1 3 -1 3 -1 3 -1 3 -1 3 -1 3 -1 
3 -1 3 -1 3 -1 3 -1 3 -1 3 -1 3 -1 3 -1 3 -1 3 -1 3 -1 3 -1 3 -1 3 -1 3 -1 3 -1 3 -1 3 -1 3 -1 3 -1 
-1
