25
25
2
3 -1 3 -1 3 0 3 -1 3 -1 3 -1 3 -1 3 -1 2 -1 3 -1 3 -1 401 -1 3 -1 3 -1 3 -1 2 -1 2 -1 3 -1 3 -1 2 -1 3 -1 3 -1 2 -1 2 -1 3 -1 
2 -1 3 -1 3 -1 3 -1 3 -1 3 -1 3 -1 3 -1 3 -1 2 -1 3 -1 3 -1 3 -1 3 -1 3 -1 3 -1 4 -1 3 -1 3 -1 3 -1 3 -1 401 -1 2 -1 3 -1 3 -1 
2 -1 2 -1 400 0 3 -1 3 -1 2 -1 3 -1 3 -1 3 -1 3 -1 3 -1 3 -1 3 -1 2 -1 2 -1 2 -1 3 -1 3 -1 3 -1 3 -1 3 -1 3 -1 3 -1 3 -1 2 -1 
3 -1 3 -1 3 -1 3 -1 3 -1 3 -1 4 -1 2 -1 3 -1 3 -1 3 -1 3 -1 3 -1 3 -1 3 -1 2 -1 3 -1 3 -1 3 -1 3 -1 2 -1 3 -1 3 -1 3 -1 3 -1 
401 0 3 -1 3 -1 3 -1 402 0 3 -1 3 -1 3 -1 3 -1 3 -1 3 -1 3 -1 3 -1 3 -1 3 -1 3 -1 3 -1 3 -1 3 -1 3 -1 3 -1 3 -1 402 -1 3 -1 3 -1 
2 -1 2 -1 3 -1 3 -1 3 -1 304 -1 300 -1 300 -1 300 -1 300 -1 300 -1 300 -1 300 -1 300 -1 300 -1 300 -1 300 -1 300 -1 404 -1 305 -1 3 -1 3 -1 3 -1 3 -1 3 -1 
3 -1 3 -1 3 -1 3 -1 3 -1 321 -1 200 -1 200 -1 200 -1 200 -1 200 -1 200 -1 200 -1 200 -1 200 -1 200 -1 200 -1 200 -1 200 -1 301 -1 3 -1 3 -1 3 -1 4 -1 3 -1 
401 -1 3 -1 3 -1 2 -1 3 -1 214 -1 225 -1 200 -1 200 -1 200 -1 200 -1 200 -1 200 -1 200 -1 200 -1 200 -1 200 -1 200 -1 200 -1 301 -1 3 -1 3 -1 2 -1 3 -1 3 -1 
3 -1 3 -1 3 -1 3 -1 3 -1 404 -1 202 -1 200 -1 200 -1 200 -1 200 -1 200 -1 200 -1 200 -1 200 -1 200 -1 200 -1 200 -1 200 -1 301 -1 3 -1 3 -1 2 -1 2 -1 3 -1 
3 -1 3 -1 3 -1 3 -1 3 -1 210 -1 223 -1 200 -1 200 -1 200 -1 200 -1 200 -1 200 -1 200 -1 200 -1 200 -1 200 -1 200 -1 200 -1 301 -1 3 -1 3 -1 3 -1 3 -1 3 -1 
2 -1 2 -1 4 -1 3 -1 3 -1 317 -1 200 -1 200 -1 200 -1 200 -1 200 -1 200 -1 200 -1 200 -1 200 -1 200 -1 200 -1 200 -1 200 -1 301 -1 3 -1 3 -1 3 -1 3 -1 3 -1 
2 -1 2 -1 3 -1 3 -1 3 -1 303 -1 200 -1 200 -1 200 -1 200 -1 200 -1 200 -1 200 -1 200 -1 200 -1 200 -1 200 -1 200 -1 200 -1 301 -1 401 -1 3 -1 3 -1 3 -1 3 -1 
3 -1 3 -1 3 -1 3 -1 3 -1 303 -1 200 -1 200 -1 200 -1 200 -1 200 -1 200 -1 200 -1 200 -1 200 -1 200 -1 200 -1 200 -1 200 -1 301 -1 3 -1 2 -1 3 -1 3 -1 3 -1 
3 -1 3 -1 3 -1 3 -1 3 -1 303 -1 200 -1 200 -1 200 -1 200 -1 200 -1 200 -1 200 -1 200 -1 200 -1 200 -1 200 -1 200 -1 200 -1 301 -1 3 -1 3 -1 3 -1 3 -1 2 -1 
3 -1 401 -1 3 -1 3 -1 3 -1 303 -1 200 -1 200 -1 200 -1 200 -1 200 -1 200 -1 200 -1 200 -1 200 -1 200 -1 200 -1 200 -1 200 -1 319 -1 2 -1 2 -1 3 -1 3 -1 4 -1 
3 -1 3 -1 2 -1 3 -1 3 -1 303 -1 200 -1 200 -1 200 -1 200 -1 200 -1 200 -1 200 -1 200 -1 200 -1 200 -1 200 -1 200 -1 224 -1 212 -1 3 -1 3 -1 2 -1 3 -1 3 -1 
3 -1 3 -1 3 -1 3 -1 3 -1 303 -1 200 -1 200 -1 200 -1 200 -1 200 -1 200 -1 200 -1 200 -1 200 -1 200 -1 200 -1 200 -1 204 -1 404 -1 3 -1 3 -1 3 -1 3 -1 3 -1 
3 -1 3 -1 4 -1 3 -1 3 -1 303 -1 200 -1 200 -1 200 -1 200 -1 200 -1 200 -1 200 -1 200 -1 200 -1 200 -1 200 -1 200 -1 222 -1 208 -1 3 -1 3 -1 3 -1 3 -1 3 -1 
3 -1 3 -1 3 -1 3 -1 3 -1 303 -1 200 -1 200 -1 200 -1 200 -1 200 -1 200 -1 200 -1 200 -1 200 -1 200 -1 200 -1 200 -1 200 -1 323 -1 3 -1 3 -1 3 -1 3 -1 401 -1 
2 -1 3 -1 3 -1 3 -1 3 -1 306 -1 404 -1 302 -1 302 -1 302 -1 302 -1 302 -1 302 -1 302 -1 302 -1 302 -1 302 -1 302 -1 302 -1 307 -1 3 -1 3 -1 2 -1 3 -1 3 -1 
2 -1 3 -1 3 -1 2 -1 3 -1 3 -1 3 -1 3 -1 3 -1 3 -1 3 -1 3 -1 3 -1 2 -1 3 -1 3 -1 3 -1 3 -1 3 -1 3 -1 402 1 3 -1 2 -1 3 -1 3 -1 
3 -1 3 -1 3 -1 3 -1 3 -1 2 -1 3 -1 3 -1 3 -1 3 -1 3 -1 3 -1 3 -1 3 -1 3 -1 3 -1 3 -1 3 -1 3 -1 3 -1 3 -1 3 -1 3 -1 3 -1 3 1 
3 -1 3 -1 3 -1 3 -1 402 -1 3 -1 3 -1 3 -1 3 -1 3 -1 2 -1 3 -1 3 -1 3 -1 3 -1 3 -1 3 -1 3 -1 3 -1 3 -1 3 -1 3 -1 400 1 3 -1 3 -1 
3 -1 401 -1 3 -1 3 -1 3 -1 3 -1 3 -1 3 -1 3 -1 2 -1 2 -1 3 -1 401 -1 4 -1 3 -1 2 -1 2 -1 3 -1 3 -1 3 -1 3 -1 3 -1 3 -1 3 -1 3 -1 
3 -1 2 -1 2 -1 3 -1 3 -1 3 -1 3 -1 3 -1 3 -1 3 -1 3 -1 3 -1 3 -1 3 -1 3 -1 2 -1 2 -1 3 -1 3 -1 3 -1 401 1 3 -1 3 -1 2 -1 3 -1 
-1
