20
30
2
3 -1 2 -1 3 -1 3 -1 3 -1 3 -1 3 -1 4 -1 3 -1 3 -1 3 -1 3 -1 2 -1 2 -1 601 -1 303 -1 200 -1 200 -1 200 -1 200 -1 
2 -1 3 -1 3 -1 3 -1 3 -1 3 -1 3 -1 4 -1 3 -1 3 -1 600 -1 3 -1 3 -1 3 -1 601 -1 303 -1 200 -1 200 -1 200 -1 200 -1 
3 -1 3 -1 3 -1 2 -1 3 -1 600 -1 3 -1 601 -1 3 -1 3 -1 3 -1 3 -1 401 -1 3 -1 601 -1 306 -1 302 -1 302 -1 302 -1 302 -1 
3 -1 3 -1 3 -1 2 -1 3 -1 3 -1 3 -1 601 -1 3 -1 3 -1 3 -1 3 -1 3 -1 3 -1 601 -1 601 -1 601 -1 601 -1 601 -1 601 -1 
3 -1 3 -1 2 -1 3 -1 3 -1 3 -1 3 -1 601 -1 2 -1 3 -1 3 -1 3 -1 3 -1 3 -1 4 -1 3 -1 3 -1 2 -1 3 -1 3 -1 
2 -1 3 -1 402 0 2 -1 3 -1 3 -1 3 -1 601 -1 3 -1 3 -1 3 -1 3 -1 3 -1 3 -1 601 -1 2 -1 3 -1 600 -1 3 -1 3 -1 
3 -1 3 -1 3 -1 3 -1 3 -1 3 -1 3 -1 601 -1 2 -1 3 -1 3 -1 3 -1 600 -1 3 -1 601 -1 2 -1 3 -1 3 -1 3 -1 3 -1 
3 -1 600 -1 3 -1 3 -1 400 0 3 -1 3 -1 601 -1 3 -1 3 -1 401 -1 3 -1 3 -1 3 -1 601 -1 3 -1 3 -1 3 -1 3 -1 3 -1 
3 -1 3 -1 3 -1 3 -1 3 -1 3 -1 2 -1 601 -1 3 -1 3 -1 2 -1 3 -1 3 -1 3 -1 601 -1 3 -1 401 -1 3 -1 2 -1 3 -1 
4 -1 4 -1 601 -1 601 -1 601 -1 601 -1 601 -1 601 -1 601 -1 601 -1 601 -1 601 -1 601 -1 601 -1 601 -1 3 -1 3 -1 3 -1 3 -1 402 -1 
2 -1 2 -1 3 -1 3 -1 601 -1 3 -1 3 -1 3 -1 3 -1 3 -1 3 -1 3 -1 3 -1 3 -1 601 -1 2 -1 2 -1 3 -1 3 -1 3 -1 
3 -1 3 -1 3 -1 3 -1 601 -1 3 -1 3 -1 3 -1 2 -1 2 -1 600 -1 3 -1 3 -1 3 -1 601 -1 3 -1 3 -1 2 -1 3 -1 3 -1 
3 -1 3 -1 3 -1 2 -1 601 -1 3 -1 3 -1 3 -1 3 -1 2 -1 3 -1 3 -1 401 -1 3 -1 601 -1 3 -1 2 -1 3 -1 3 -1 3 -1 
3 -1 3 -1 600 -1 3 -1 601 -1 3 -1 3 -1 3 -1 3 -1 3 -1 3 -1 3 -1 3 -1 2 -1 4 -1 3 -1 3 -1 600 -1 3 -1 3 -1 
2 -1 2 -1 3 -1 3 -1 601 -1 3 -1 402 -1 3 -1 3 -1 3 -1 600 -1 3 -1 3 -1 3 -1 601 -1 601 -1 601 -1 601 -1 601 -1 4 -1 
2 -1 3 -1 3 -1 3 -1 4 -1 3 -1 3 -1 2 -1 3 -1 3 -1 3 -1 3 -1 2 -1 3 -1 601 -1 2 -1 3 -1 3 -1 3 -1 2 -1 
601 -1 601 -1 601 -1 601 -1 601 -1 601 -1 601 -1 601 -1 4 -1 601 -1 601 -1 601 -1 601 -1 4 -1 601 -1 3 -1 3 -1 600 -1 3 -1 3 -1 
600 -1 3 -1 2 -1 3 -1 601 -1 3 -1 3 -1 3 -1 3 -1 601 -1 3 -1 3 -1 3 -1 3 -1 601 -1 3 -1 2 -1 3 -1 3 -1 401 -1 
3 -1 3 -1 402 -1 3 -1 601 -1 3 -1 2 -1 3 -1 3 -1 601 -1 3 -1 3 -1 402 -1 3 -1 601 -1 3 -1 3 -1 403 -1 3 -1 3 -1 
401 -1 3 -1 3 -1 3 -1 601 -1 3 -1 600 -1 3 -1 3 -1 601 -1 3 -1 3 -1 3 -1 3 -1 601 -1 3 -1 3 -1 3 -1 3 -1 3 -1 
601 -1 601 -1 601 -1 4 -1 601 -1 3 -1 3 -1 3 -1 3 -1 601 -1 600 -1 3 -1 3 -1 3 -1 4 -1 3 -1 3 -1 3 -1 3 -1 3 -1 
3 -1 2 -1 3 -1 3 -1 2 -1 3 -1 401 -1 3 -1 3 -1 601 -1 601 -1 601 -1 601 -1 601 -1 601 -1 601 -1 601 -1 601 -1 601 -1 601 -1 
2 -1 600 -1 3 -1 2 -1 3 -1 3 -1 3 -1 2 -1 3 -1 601 -1 3 -1 3 -1 2 -1 3 -1 2 -1 3 -1 3 -1 3 -1 3 -1 3 -1 
3 -1 3 -1 3 -1 3 -1 401 -1 3 -1 3 -1 2 -1 3 -1 601 -1 2 -1 401 -1 3 -1 401 -1 3 -1 3 -1 2 -1 3 -1 600 -1 3 -1 
4 -1 4 -1 601 -1 601 -1 601 -1 601 -1 601 -1 601 -1 601 -1 601 -1 3 -1 3 -1 2 -1 3 -1 2 -1 3 -1 3 -1 3 -1 3 -1 3 -1 
3 -1 3 -1 3 -1 3 -1 3 -1 3 -1 3 -1 3 -1 3 -1 601 -1 4 -1 601 -1 601 -1 601 -1 601 -1 4 -1 601 -1 601 -1 601 -1 601 -1 
3 -1 600 -1 3 -1 3 -1 3 -1 3 -1 400 1 3 -1 3 -1 601 -1 3 -1 3 -1 3 -1 3 -1 601 -1 3 -1 3 -1 2 -1 3 -1 3 -1 
3 -1 3 -1 2 -1 2 -1 3 -1 3 -1 3 -1 3 -1 3 -1 601 -1 3 -1 3 -1 600 -1 3 -1 601 -1 3 -1 3 -1 3 -1 3 -1 401 -1 
3 -1 3 -1 3 -1 3 -1 3 -1 402 1 3 -1 600 -1 3 -1 4 -1 3 -1 3 -1 3 -1 3 -1 601 -1 600 -1 3 -1 402 -1 3 -1 3 -1 
3 -1 3 -1 3 -1 3 -1 3 -1 3 -1 2 -1 3 -1 3 -1 4 -1 3 -1 3 -1 3 -1 3 -1 601 -1 3 -1 3 -1 2 -1 3 -1 3 -1 
-1
