20
18
4
4 -1 4 -1 4 -1 4 -1 4 -1 4 -1 4 -1 4 -1 4 -1 4 -1 4 -1 4 -1 4 -1 4 -1 4 -1 4 -1 4 -1 4 -1 4 -1 4 -1 
2 -1 3 -1 401 -1 3 -1 2 -1 2 -1 2 -1 2 -1 2 -1 2 -1 401 -1 13 -1 5 -1 5 -1 13 -1 5 -1 13 -1 401 -1 402 -1 2 -1 
9 -1 5 -1 12 -1 5 -1 5 -1 5 -1 5 -1 5 -1 5 -1 5 -1 5 -1 8 -1 3 -1 3 -1 6 -1 4 -1 7 -1 5 -1 8 -1 2 -1 
401 -1 3 -1 2 -1 4 -1 4 -1 4 -1 4 -1 2 -1 3 -1 3 -1 3 -1 3 -1 3 -1 3 -1 6 -1 4 -1 4 -1 4 -1 3 -1 2 -1 
6 -1 2 -1 4 -1 4 -1 401 -1 4 -1 4 -1 4 -1 4 -1 401 -1 13 -1 5 -1 13 -1 5 -1 400 1 5 -1 401 1 4 -1 4 -1 3 -1 
6 -1 4 -1 4 -1 3 -1 6 -1 3 -1 4 -1 4 -1 4 -1 3 -1 6 -1 3 -1 6 -1 3 -1 3 -1 3 -1 4 -1 4 -1 4 -1 3 -1 
6 -1 4 -1 3 -1 3 -1 11 -1 5 -1 401 0 4 -1 4 -1 4 -1 6 -1 2 -1 401 -1 3 -1 3 -1 4 -1 4 -1 4 -1 4 -1 2 -1 
11 -1 13 -1 5 -1 5 -1 12 -1 400 0 5 -1 10 -1 210 -1 208 -1 402 1 2 -1 4 -1 4 -1 4 -1 4 -1 4 -1 4 -1 3 -1 2 -1 
402 -1 6 -1 3 -1 3 -1 3 -1 3 -1 3 -1 402 0 313 -1 222 -1 314 -1 208 -1 4 -1 2 -1 4 -1 3 -1 4 -1 3 -1 3 -1 3 -1 
2 -1 6 -1 3 -1 3 -1 3 -1 4 -1 4 -1 4 -1 234 -1 316 -1 320 -1 212 -1 2 -1 3 -1 401 -1 3 -1 3 -1 2 -1 2 -1 401 -1 
3 -1 11 -1 401 -1 3 -1 4 -1 4 -1 4 -1 3 -1 217 -1 402 3 3 -1 4 -1 4 -1 3 -1 6 -1 3 -1 3 -1 2 -1 2 -1 6 -1 
2 -1 6 -1 3 -1 4 -1 2 -1 4 -1 3 -1 401 3 5 -1 8 -1 4 -1 4 -1 402 2 13 -1 12 -1 400 2 5 -1 5 -1 5 -1 14 -1 
2 -1 6 -1 3 -1 4 -1 4 -1 402 -1 5 -1 14 -1 3 -1 3 -1 3 -1 4 -1 4 -1 401 2 3 -1 3 -1 4 -1 4 -1 3 -1 6 -1 
9 -1 14 -1 3 -1 4 -1 4 -1 3 -1 3 -1 400 3 3 -1 3 -1 401 -1 4 -1 4 -1 4 -1 4 -1 4 -1 4 -1 4 -1 2 -1 6 -1 
6 -1 401 -1 3 -1 3 -1 4 -1 4 -1 3 -1 6 -1 3 -1 2 -1 6 -1 3 -1 4 -1 4 -1 4 -1 4 -1 401 -1 2 -1 2 -1 6 -1 
401 -1 12 -1 5 -1 5 -1 5 -1 5 -1 5 -1 12 -1 5 -1 5 -1 401 -1 5 -1 5 -1 5 -1 5 -1 5 -1 12 -1 5 -1 5 -1 402 -1 
4 -1 4 -1 4 -1 4 -1 4 -1 4 -1 4 -1 4 -1 4 -1 4 -1 4 -1 4 -1 4 -1 4 -1 4 -1 4 -1 4 -1 4 -1 4 -1 4 -1 
4 -1 4 -1 4 -1 4 -1 4 -1 4 -1 4 -1 4 -1 4 -1 4 -1 4 -1 4 -1 4 -1 4 -1 4 -1 4 -1 4 -1 4 -1 4 -1 4 -1 
-1
