31
31
4
208 -1 2 -1 2 -1 2 -1 2 -1 3 -1 3 -1 6 -1 3 -1 3 -1 2 -1 2 -1 3 0 202 -1 200 -1 200 -1 200 -1 204 -1 3 1 2 -1 2 -1 3 -1 3 -1 6 -1 3 -1 3 -1 2 -1 2 -1 2 -1 2 -1 210 -1 
222 -1 208 -1 2 -1 2 -1 3 -1 400 0 3 -1 6 -1 3 -1 402 0 3 -1 2 -1 401 0 202 -1 200 -1 200 -1 200 -1 204 -1 401 1 2 -1 3 -1 402 1 3 -1 6 -1 3 -1 400 1 3 -1 2 -1 2 -1 210 -1 223 -1 
200 -1 222 -1 208 -1 2 -1 3 -1 3 -1 3 -1 6 -1 3 -1 3 -1 3 -1 3 -1 3 0 202 -1 200 -1 200 -1 200 -1 204 -1 3 1 3 -1 3 -1 3 -1 3 -1 6 -1 3 -1 3 -1 3 -1 2 -1 210 -1 223 -1 200 -1 
200 -1 200 -1 222 -1 208 -1 3 -1 3 -1 3 -1 6 -1 3 -1 3 -1 3 -1 3 -1 401 0 202 -1 200 -1 200 -1 200 -1 204 -1 401 1 3 -1 3 -1 3 -1 3 -1 6 -1 3 -1 3 -1 3 -1 210 -1 223 -1 200 -1 200 -1 
200 -1 200 -1 200 -1 222 -1 208 -1 3 -1 402 0 7 -1 5 -1 5 -1 10 -1 3 -1 3 0 202 -1 200 -1 200 -1 200 -1 204 -1 3 1 3 -1 9 -1 5 -1 5 -1 8 -1 402 1 3 -1 210 -1 223 -1 200 -1 200 -1 200 -1 
200 -1 200 -1 200 -1 200 -1 222 -1 208 -1 3 -1 3 -1 2 -1 2 -1 6 -1 3 -1 401 0 214 -1 225 -1 200 -1 224 -1 212 -1 401 1 3 -1 6 -1 2 -1 2 -1 3 -1 3 -1 210 -1 223 -1 200 -1 200 -1 200 -1 200 -1 
200 -1 200 -1 200 -1 200 -1 200 -1 222 -1 208 -1 3 -1 3 -1 2 -1 6 -1 3 -1 2 -1 3 -1 202 -1 200 -1 204 -1 3 -1 2 -1 3 -1 6 -1 2 -1 3 -1 3 -1 210 -1 223 -1 200 -1 200 -1 200 -1 200 -1 200 -1 
200 -1 200 -1 200 -1 200 -1 200 -1 200 -1 222 -1 208 -1 3 -1 3 -1 18 -1 3 -1 3 -1 2 -1 202 -1 200 -1 204 -1 2 -1 3 -1 3 -1 6 -1 3 -1 3 -1 210 -1 223 -1 200 -1 200 -1 200 -1 200 -1 200 -1 200 -1 
200 -1 200 -1 200 -1 200 -1 200 -1 200 -1 200 -1 222 -1 208 -1 3 -1 7 -1 13 -1 5 -1 10 -1 202 -1 200 -1 204 -1 9 -1 5 -1 13 -1 8 -1 3 -1 210 -1 223 -1 200 -1 200 -1 200 -1 200 -1 200 -1 200 -1 200 -1 
200 -1 200 -1 200 -1 200 -1 200 -1 200 -1 200 -1 200 -1 222 -1 208 -1 2 -1 6 -1 3 -1 6 -1 234 -1 312 -1 243 -1 6 -1 3 -1 6 -1 2 -1 210 -1 223 -1 200 -1 200 -1 200 -1 200 -1 200 -1 200 -1 200 -1 200 -1 
200 -1 200 -1 200 -1 200 -1 200 -1 200 -1 200 -1 200 -1 200 -1 222 -1 208 -1 6 -1 3 -1 6 -1 207 -1 401 -1 207 -1 6 -1 3 -1 6 -1 210 -1 223 -1 200 -1 200 -1 200 -1 200 -1 200 -1 200 -1 200 -1 200 -1 200 -1 
200 -1 200 -1 200 -1 200 -1 200 -1 200 -1 200 -1 200 -1 200 -1 200 -1 204 -1 18 -1 3 -1 18 -1 217 -1 17 -1 217 -1 18 -1 3 -1 18 -1 202 -1 200 -1 200 -1 200 -1 200 -1 200 -1 200 -1 200 -1 200 -1 200 -1 200 -1 
200 -1 200 -1 200 -1 200 -1 200 -1 200 -1 200 -1 200 -1 200 -1 224 -1 212 -1 7 -1 5 -1 12 -1 5 -1 15 -1 5 -1 12 -1 5 -1 8 -1 214 -1 225 -1 200 -1 200 -1 200 -1 200 -1 200 -1 200 -1 200 -1 200 -1 200 -1 
200 -1 200 -1 200 -1 200 -1 200 -1 200 -1 200 -1 200 -1 224 -1 212 -1 2 -1 3 -1 3 -1 402 -1 4 -1 6 -1 4 -1 402 -1 3 -1 3 -1 2 -1 214 -1 225 -1 200 -1 200 -1 200 -1 200 -1 200 -1 200 -1 200 -1 200 -1 
200 -1 200 -1 200 -1 200 -1 200 -1 200 -1 224 -1 205 -1 212 -1 3 -1 3 -1 401 -1 2 -1 4 -1 9 -1 12 -1 10 -1 4 -1 2 -1 401 -1 3 -1 3 -1 214 -1 205 -1 225 -1 200 -1 200 -1 200 -1 200 -1 200 -1 200 -1 
200 -1 200 -1 200 -1 200 -1 200 -1 200 -1 404 -1 401 -1 19 -1 5 -1 5 -1 5 -1 5 -1 5 -1 14 -1 403 -1 11 -1 5 -1 5 -1 5 -1 5 -1 5 -1 16 -1 401 -1 404 -1 200 -1 200 -1 200 -1 200 -1 200 -1 200 -1 
200 -1 200 -1 200 -1 200 -1 200 -1 200 -1 222 -1 203 -1 208 -1 3 -1 3 -1 401 -1 2 -1 4 -1 7 -1 13 -1 8 -1 4 -1 2 -1 401 -1 3 -1 3 -1 210 -1 203 -1 223 -1 200 -1 200 -1 200 -1 200 -1 200 -1 200 -1 
200 -1 200 -1 200 -1 200 -1 200 -1 200 -1 200 -1 200 -1 222 -1 208 -1 2 -1 3 -1 3 -1 402 -1 4 -1 6 -1 4 -1 402 -1 3 -1 3 -1 2 -1 210 -1 223 -1 200 -1 200 -1 200 -1 200 -1 200 -1 200 -1 200 -1 200 -1 
200 -1 200 -1 200 -1 200 -1 200 -1 200 -1 200 -1 200 -1 200 -1 222 -1 208 -1 9 -1 5 -1 13 -1 5 -1 15 -1 5 -1 13 -1 5 -1 10 -1 210 -1 223 -1 200 -1 200 -1 200 -1 200 -1 200 -1 200 -1 200 -1 200 -1 200 -1 
200 -1 200 -1 200 -1 200 -1 200 -1 200 -1 200 -1 200 -1 200 -1 200 -1 204 -1 18 -1 3 -1 18 -1 218 -1 18 -1 218 -1 18 -1 3 -1 18 -1 202 -1 200 -1 200 -1 200 -1 200 -1 200 -1 200 -1 200 -1 200 -1 200 -1 200 -1 
200 -1 200 -1 200 -1 200 -1 200 -1 200 -1 200 -1 200 -1 200 -1 224 -1 212 -1 6 -1 3 -1 6 -1 207 -1 401 -1 207 -1 6 -1 3 -1 6 -1 214 -1 225 -1 200 -1 200 -1 200 -1 200 -1 200 -1 200 -1 200 -1 200 -1 200 -1 
200 -1 200 -1 200 -1 200 -1 200 -1 200 -1 200 -1 200 -1 224 -1 212 -1 2 -1 6 -1 3 -1 6 -1 235 -1 314 -1 242 -1 6 -1 3 -1 6 -1 2 -1 214 -1 225 -1 200 -1 200 -1 200 -1 200 -1 200 -1 200 -1 200 -1 200 -1 
200 -1 200 -1 200 -1 200 -1 200 -1 200 -1 200 -1 224 -1 212 -1 3 -1 9 -1 12 -1 5 -1 8 -1 202 -1 200 -1 204 -1 7 -1 5 -1 12 -1 10 -1 3 -1 214 -1 225 -1 200 -1 200 -1 200 -1 200 -1 200 -1 200 -1 200 -1 
200 -1 200 -1 200 -1 200 -1 200 -1 200 -1 224 -1 212 -1 3 -1 3 -1 17 -1 3 -1 3 -1 2 -1 202 -1 200 -1 204 -1 2 -1 3 -1 3 -1 17 -1 3 -1 3 -1 214 -1 225 -1 200 -1 200 -1 200 -1 200 -1 200 -1 200 -1 
200 -1 200 -1 200 -1 200 -1 200 -1 224 -1 212 -1 3 -1 3 -1 3 -1 6 -1 3 -1 2 -1 3 -1 202 -1 200 -1 204 -1 3 -1 2 -1 3 -1 6 -1 3 -1 3 -1 3 -1 214 -1 225 -1 200 -1 200 -1 200 -1 200 -1 200 -1 
200 -1 200 -1 200 -1 200 -1 224 -1 212 -1 3 -1 3 -1 3 -1 3 -1 6 -1 3 -1 401 2 210 -1 223 -1 200 -1 222 -1 208 -1 401 3 3 -1 6 -1 3 -1 3 -1 3 -1 3 -1 214 -1 225 -1 200 -1 200 -1 200 -1 200 -1 
200 -1 200 -1 200 -1 224 -1 212 -1 3 -1 402 2 9 -1 5 -1 5 -1 8 -1 3 -1 3 2 202 -1 200 -1 200 -1 200 -1 204 -1 3 3 3 -1 7 -1 5 -1 5 -1 10 -1 402 3 3 -1 214 -1 225 -1 200 -1 200 -1 200 -1 
200 -1 200 -1 224 -1 212 -1 3 -1 3 -1 3 -1 6 -1 2 -1 2 -1 3 -1 3 -1 401 2 202 -1 200 -1 200 -1 200 -1 204 -1 401 3 3 -1 3 -1 2 -1 2 -1 6 -1 3 -1 3 -1 3 -1 214 -1 225 -1 200 -1 200 -1 
200 -1 224 -1 212 -1 2 -1 3 -1 3 -1 3 -1 6 -1 2 -1 3 -1 3 -1 3 -1 3 2 202 -1 200 -1 200 -1 200 -1 204 -1 3 3 3 -1 3 -1 3 -1 2 -1 6 -1 3 -1 3 -1 3 -1 2 -1 214 -1 225 -1 200 -1 
224 -1 212 -1 2 -1 2 -1 3 -1 400 2 3 -1 6 -1 3 -1 402 2 3 -1 2 -1 401 2 202 -1 200 -1 200 -1 200 -1 204 -1 401 3 2 -1 3 -1 402 3 3 -1 6 -1 3 -1 400 3 3 -1 2 -1 2 -1 214 -1 225 -1 
212 -1 2 -1 2 -1 2 -1 2 -1 3 -1 3 -1 6 -1 3 -1 3 -1 2 -1 2 -1 3 2 202 -1 200 -1 200 -1 200 -1 204 -1 3 3 2 -1 2 -1 3 -1 3 -1 6 -1 3 -1 3 -1 2 -1 2 -1 2 -1 2 -1 214 -1 
-1
