30
20
4
601 -1 601 -1 601 -1 6 -1 601 -1 601 -1 601 -1 6 -1 601 -1 601 -1 601 -1 6 -1 601 -1 601 -1 601 -1 6 -1 601 -1 601 -1 601 -1 6 -1 601 -1 601 -1 601 -1 6 -1 601 -1 601 -1 601 -1 6 -1 601 -1 601 -1 
5 -1 5 -1 5 -1 15 -1 5 -1 5 -1 5 -1 15 -1 5 -1 5 -1 5 -1 15 -1 5 -1 5 -1 5 -1 15 -1 5 -1 5 -1 5 -1 15 -1 5 -1 5 -1 5 -1 15 -1 5 -1 5 -1 5 -1 15 -1 5 -1 5 -1 
601 -1 601 -1 601 -1 6 -1 601 -1 601 -1 601 -1 6 -1 601 -1 601 -1 601 -1 6 -1 601 -1 401 1 601 1 6 -1 601 -1 601 -1 601 -1 6 -1 601 -1 601 -1 601 -1 6 -1 601 -1 601 -1 601 -1 6 -1 601 -1 601 -1 
601 -1 601 -1 601 -1 6 -1 601 -1 601 -1 601 -1 6 -1 601 -1 601 -1 601 -1 6 -1 401 1 400 1 402 1 6 -1 401 -1 402 -1 601 -1 6 -1 601 -1 601 -1 601 -1 6 -1 601 -1 601 -1 601 -1 6 -1 601 -1 601 -1 
5 -1 5 -1 5 -1 15 -1 5 -1 5 -1 5 -1 15 -1 5 -1 5 -1 5 -1 15 -1 5 -1 5 -1 5 -1 15 -1 5 -1 5 -1 5 -1 15 -1 5 -1 5 -1 5 -1 15 -1 5 -1 5 -1 5 -1 15 -1 5 -1 5 -1 
601 -1 601 -1 601 -1 6 -1 601 -1 601 -1 601 -1 6 -1 601 -1 601 -1 601 -1 6 -1 601 -1 601 -1 601 -1 6 -1 601 -1 601 -1 601 -1 6 -1 601 -1 601 -1 601 -1 6 -1 601 -1 601 -1 601 -1 6 -1 601 -1 601 -1 
601 -1 601 -1 601 -1 6 -1 601 -1 601 -1 601 -1 6 -1 601 -1 401 -1 401 -1 6 -1 601 -1 601 -1 601 -1 6 -1 601 -1 601 -1 601 -1 6 -1 401 -1 401 -1 601 -1 6 -1 601 -1 601 -1 601 -1 6 -1 601 -1 601 -1 
5 -1 5 -1 5 -1 15 -1 5 -1 5 -1 5 -1 15 -1 5 -1 5 -1 5 -1 15 -1 5 -1 13 -1 5 -1 15 -1 5 -1 13 -1 5 -1 15 -1 5 -1 5 -1 5 -1 15 -1 5 -1 5 -1 5 -1 15 -1 5 -1 5 -1 
601 -1 601 -1 601 -1 6 -1 601 -1 601 -1 601 -1 6 -1 601 -1 601 -1 601 -1 6 -1 601 -1 6 -1 601 -1 601 -1 601 -1 6 -1 601 -1 6 -1 601 -1 601 -1 601 -1 6 -1 400 2 401 2 601 -1 6 -1 601 -1 601 -1 
601 -1 601 -1 601 -1 6 -1 601 -1 402 -1 401 -1 6 -1 601 -1 601 -1 601 -1 11 -1 5 -1 15 -1 5 -1 5 -1 5 -1 15 -1 5 -1 14 -1 601 -1 601 -1 601 -1 6 -1 402 2 401 2 601 2 6 -1 601 -1 601 -1 
5 -1 5 -1 5 -1 15 -1 5 -1 5 -1 5 -1 15 -1 5 -1 5 -1 5 -1 15 -1 601 -1 6 -1 401 -1 402 -1 401 -1 6 -1 601 -1 15 -1 5 -1 5 -1 5 -1 15 -1 5 -1 5 -1 5 -1 15 -1 5 -1 5 -1 
601 -1 601 -1 601 -1 6 -1 601 0 401 0 402 0 6 -1 601 -1 601 -1 601 -1 11 -1 5 -1 15 -1 5 -1 5 -1 5 -1 15 -1 5 -1 14 -1 601 -1 601 -1 601 -1 6 -1 401 -1 402 -1 601 -1 6 -1 601 -1 601 -1 
601 -1 601 -1 601 -1 6 -1 601 -1 401 0 400 0 6 -1 601 -1 601 -1 601 -1 6 -1 601 -1 6 -1 601 -1 601 -1 601 -1 6 -1 601 -1 6 -1 601 -1 601 -1 601 -1 6 -1 601 -1 601 -1 601 -1 6 -1 601 -1 601 -1 
5 -1 5 -1 5 -1 15 -1 5 -1 5 -1 5 -1 15 -1 5 -1 5 -1 5 -1 15 -1 5 -1 12 -1 5 -1 15 -1 5 -1 12 -1 5 -1 15 -1 5 -1 5 -1 5 -1 15 -1 5 -1 5 -1 5 -1 15 -1 5 -1 5 -1 
601 -1 601 -1 601 -1 6 -1 601 -1 601 -1 601 -1 6 -1 601 -1 401 -1 401 -1 6 -1 601 -1 601 -1 601 -1 6 -1 601 -1 601 -1 601 -1 6 -1 401 -1 401 -1 601 -1 6 -1 601 -1 601 -1 601 -1 6 -1 601 -1 601 -1 
601 -1 601 -1 601 -1 6 -1 601 -1 601 -1 601 -1 6 -1 601 -1 601 -1 601 -1 6 -1 601 -1 601 -1 601 -1 6 -1 601 -1 601 -1 601 -1 6 -1 601 -1 601 -1 601 -1 6 -1 601 -1 601 -1 601 -1 6 -1 601 -1 601 -1 
5 -1 5 -1 5 -1 15 -1 5 -1 5 -1 5 -1 15 -1 5 -1 5 -1 5 -1 15 -1 5 -1 5 -1 5 -1 15 -1 5 -1 5 -1 5 -1 15 -1 5 -1 5 -1 5 -1 15 -1 5 -1 5 -1 5 -1 15 -1 5 -1 5 -1 
601 -1 601 -1 601 -1 6 -1 601 -1 601 -1 601 -1 6 -1 601 -1 601 -1 601 -1 6 -1 601 -1 402 -1 401 -1 6 -1 402 3 400 3 401 3 6 -1 601 -1 601 -1 601 -1 6 -1 601 -1 601 -1 601 -1 6 -1 601 -1 601 -1 
601 -1 601 -1 601 -1 6 -1 601 -1 601 -1 601 -1 6 -1 601 -1 601 -1 601 -1 6 -1 601 -1 601 -1 601 -1 6 -1 601 3 401 3 601 -1 6 -1 601 -1 601 -1 601 -1 6 -1 601 -1 601 -1 601 -1 6 -1 601 -1 601 -1 
5 -1 5 -1 5 -1 15 -1 5 -1 5 -1 5 -1 15 -1 5 -1 5 -1 5 -1 15 -1 5 -1 5 -1 5 -1 15 -1 5 -1 5 -1 5 -1 15 -1 5 -1 5 -1 5 -1 15 -1 5 -1 5 -1 5 -1 15 -1 5 -1 5 -1 
-1
