30
30
4
3 -1 3 -1 3 -1 3 -1 3 -1 3 -1 401 -1 3 -1 3 -1 3 -1 3 -1 303 -1 200 -1 200 -1 200 -1 200 -1 200 -1 301 -1 3 -1 3 -1 3 -1 3 -1 401 -1 3 -1 3 -1 3 -1 3 -1 3 -1 3 -1 3 -1 
3 -1 400 0 402 0 3 -1 3 -1 3 -1 3 -1 304 -1 318 -1 208 0 404 0 321 -1 200 -1 200 -1 200 -1 200 -1 200 -1 319 -1 404 1 210 -1 322 1 305 -1 3 -1 3 -1 3 -1 3 -1 3 -1 402 1 400 1 3 -1 
3 -1 402 0 3 -1 3 -1 3 -1 3 -1 304 -1 309 -1 200 -1 222 -1 203 -1 223 -1 200 -1 200 -1 200 -1 200 -1 200 -1 222 -1 203 -1 223 -1 200 -1 310 -1 305 -1 3 -1 3 -1 3 -1 3 -1 3 -1 402 1 3 -1 
3 -1 3 -1 3 -1 3 0 3 -1 304 -1 309 -1 200 -1 200 -1 200 -1 200 -1 200 -1 200 -1 200 -1 200 -1 201 -1 200 -1 200 -1 200 -1 200 -1 200 -1 200 -1 310 -1 305 -1 3 -1 3 -1 3 1 3 -1 3 -1 3 -1 
3 -1 3 -1 401 -1 3 -1 304 -1 309 -1 200 -1 200 -1 200 -1 200 -1 201 -1 200 -1 200 -1 200 -1 200 -1 200 -1 200 -1 200 -1 200 -1 200 -1 200 -1 200 -1 200 -1 310 -1 305 -1 3 -1 401 -1 3 -1 3 -1 3 -1 
3 -1 3 -1 3 -1 304 -1 309 -1 200 -1 200 -1 200 -1 200 -1 200 -1 200 -1 200 -1 200 -1 200 -1 200 -1 200 -1 200 -1 200 -1 200 -1 200 -1 200 -1 200 -1 200 -1 200 -1 310 -1 305 -1 3 -1 3 -1 3 -1 3 -1 
401 -1 3 -1 304 -1 309 -1 200 -1 200 -1 200 -1 200 -1 200 -1 200 -1 200 -1 200 -1 200 -1 200 -1 200 -1 200 -1 200 -1 200 -1 200 -1 200 -1 201 -1 200 -1 200 -1 200 -1 200 -1 310 -1 305 -1 3 -1 3 -1 3 -1 
3 -1 304 -1 309 -1 200 -1 200 -1 200 -1 200 -1 311 -1 302 -1 302 -1 200 -1 200 -1 200 -1 200 -1 200 -1 200 -1 200 -1 200 -1 200 -1 200 -1 200 -1 200 -1 200 -1 200 -1 200 -1 200 -1 310 -1 305 -1 3 -1 401 -1 
3 -1 321 -1 200 -1 200 -1 200 -1 200 -1 200 -1 301 -1 401 -1 2 -1 306 -1 308 -1 200 -1 200 -1 200 -1 200 -1 201 -1 200 -1 200 -1 200 -1 200 -1 200 -1 200 -1 201 -1 200 -1 200 -1 200 -1 310 -1 305 -1 3 -1 
3 -1 214 0 225 -1 200 -1 201 -1 200 -1 200 -1 301 -1 2 -1 3 -1 3 -1 303 -1 200 -1 200 -1 200 -1 200 -1 200 -1 200 -1 200 -1 200 -1 200 -1 200 -1 200 -1 200 -1 200 -1 200 -1 200 -1 200 -1 319 1 3 -1 
3 -1 404 0 202 -1 200 -1 200 -1 200 -1 200 -1 310 -1 305 -1 2 -1 2 -1 303 -1 200 -1 311 -1 302 -1 308 -1 200 -1 200 -1 200 -1 200 -1 200 -1 200 -1 311 -1 302 -1 308 -1 200 -1 200 -1 224 -1 212 -1 3 -1 
300 -1 318 -1 223 -1 200 -1 200 -1 200 -1 200 -1 200 -1 200 -1 300 -1 300 -1 309 -1 311 -1 307 -1 3 -1 306 -1 302 -1 308 -1 200 -1 200 -1 200 -1 200 -1 301 -1 401 -1 303 -1 200 -1 200 -1 204 -1 404 1 3 -1 
200 -1 200 -1 200 -1 200 -1 200 -1 200 -1 200 -1 200 -1 200 -1 200 -1 200 -1 311 -1 307 -1 401 -1 3 -1 2 -1 401 -1 306 -1 308 -1 200 -1 200 -1 200 -1 301 -1 3 -1 303 -1 200 -1 200 -1 222 -1 322 -1 300 -1 
201 -1 200 -1 200 -1 200 -1 200 -1 200 -1 200 -1 200 -1 200 -1 200 -1 311 -1 307 -1 3 -1 3 -1 3 -1 3 -1 3 -1 3 -1 306 -1 320 -1 200 -1 311 -1 307 -1 3 -1 303 -1 200 -1 200 -1 200 -1 200 -1 200 -1 
200 -1 200 -1 200 -1 200 -1 200 -1 200 -1 200 -1 200 -1 200 -1 311 -1 307 -1 401 -1 2 -1 3 -1 3 -1 402 -1 3 -1 3 -1 3 -1 3 -1 317 -1 301 -1 2 -1 2 -1 303 -1 200 -1 200 -1 200 -1 201 -1 200 -1 
200 -1 200 -1 200 -1 200 -1 200 -1 200 -1 201 -1 200 -1 200 -1 301 -1 3 -1 3 -1 3 -1 403 -1 3 -1 3 -1 3 -1 2 -1 401 -1 304 -1 309 -1 310 -1 300 -1 300 -1 309 -1 200 -1 200 -1 200 -1 200 -1 200 -1 
200 -1 200 -1 200 -1 200 -1 200 -1 200 -1 200 -1 200 -1 200 -1 310 -1 300 -1 305 -1 3 -1 3 -1 3 -1 3 -1 2 -1 3 -1 304 -1 309 -1 200 -1 200 -1 200 -1 200 -1 200 -1 200 -1 200 -1 200 -1 200 -1 200 -1 
302 -1 320 -1 225 -1 200 -1 200 -1 200 -1 200 -1 200 -1 200 -1 200 -1 200 -1 310 -1 305 -1 401 -1 2 -1 3 -1 401 -1 304 -1 309 -1 200 -1 200 -1 200 -1 200 -1 201 -1 200 -1 200 -1 200 -1 224 -1 316 -1 302 -1 
3 -1 404 2 202 -1 200 -1 200 -1 200 -1 200 -1 311 -1 302 -1 308 -1 200 -1 200 -1 310 -1 300 -1 300 -1 300 -1 300 -1 309 -1 200 -1 200 -1 200 -1 200 -1 200 -1 200 -1 200 -1 200 -1 200 -1 204 -1 404 3 3 -1 
3 -1 210 2 223 -1 200 -1 200 -1 200 -1 200 -1 301 -1 401 -1 306 -1 302 -1 302 -1 308 -1 200 -1 200 -1 200 -1 200 -1 200 -1 311 -1 302 -1 302 -1 302 -1 308 -1 200 -1 200 -1 200 -1 200 -1 222 -1 208 -1 3 -1 
3 -1 317 2 201 -1 200 -1 200 -1 200 -1 200 -1 310 -1 305 -1 3 -1 3 -1 2 -1 303 -1 200 -1 200 -1 200 -1 200 -1 200 -1 301 -1 2 -1 3 -1 401 -1 303 -1 200 -1 200 -1 200 -1 200 -1 200 -1 323 3 3 -1 
3 -1 306 -1 308 -1 200 -1 200 -1 200 -1 200 -1 200 -1 301 -1 3 -1 2 -1 3 -1 303 -1 200 -1 200 -1 200 -1 200 -1 200 -1 310 -1 300 -1 300 -1 300 -1 309 -1 200 -1 200 -1 200 -1 200 -1 311 -1 307 -1 3 -1 
401 -1 3 -1 306 -1 308 -1 200 -1 200 -1 200 -1 200 -1 310 -1 300 -1 300 -1 300 -1 309 -1 200 -1 200 -1 200 -1 200 -1 200 -1 200 -1 200 -1 200 -1 200 -1 200 -1 200 -1 201 -1 200 -1 311 -1 307 -1 3 -1 401 -1 
3 -1 3 -1 3 -1 306 -1 308 -1 200 -1 200 -1 200 -1 200 -1 200 -1 200 -1 200 -1 200 -1 200 -1 200 -1 200 -1 201 -1 200 -1 200 -1 200 -1 200 -1 200 -1 200 -1 200 -1 200 -1 311 -1 307 -1 3 -1 3 -1 3 -1 
3 -1 3 -1 3 -1 3 -1 306 -1 308 -1 200 -1 200 -1 200 -1 200 -1 200 -1 200 -1 200 -1 200 -1 200 -1 200 -1 200 -1 200 -1 200 -1 200 -1 200 -1 200 -1 200 -1 200 -1 311 -1 307 -1 3 -1 3 -1 3 -1 3 -1 
3 -1 3 -1 401 -1 3 -1 3 -1 306 -1 308 -1 200 -1 200 -1 200 -1 200 -1 200 -1 200 -1 200 -1 200 -1 200 -1 200 -1 200 -1 200 -1 200 -1 200 -1 200 -1 200 -1 311 -1 307 -1 3 -1 401 -1 3 -1 3 -1 3 -1 
3 -1 3 -1 3 -1 3 2 3 -1 3 -1 306 -1 308 -1 200 -1 200 -1 201 -1 200 -1 200 -1 200 -1 200 -1 200 -1 200 -1 200 -1 200 -1 200 -1 200 -1 200 -1 311 -1 307 -1 3 -1 3 -1 3 3 3 -1 3 -1 3 -1 
3 -1 402 2 3 -1 3 -1 3 -1 3 -1 3 -1 306 -1 308 -1 200 -1 224 -1 205 2 225 -1 200 -1 200 -1 200 -1 200 -1 224 -1 205 -1 225 -1 200 -1 311 -1 307 -1 3 -1 3 -1 3 -1 3 -1 3 -1 402 3 3 -1 
3 -1 400 2 402 2 3 -1 3 -1 3 -1 3 -1 3 -1 306 -1 320 2 212 -1 404 2 317 -1 200 -1 200 -1 200 -1 200 -1 323 -1 404 3 214 -1 316 3 307 -1 3 -1 3 -1 3 -1 3 -1 3 -1 402 3 400 3 3 -1 
3 -1 3 -1 3 -1 3 -1 3 -1 3 -1 3 -1 401 -1 3 -1 3 -1 3 -1 3 -1 303 -1 200 -1 200 -1 200 -1 200 -1 301 -1 3 -1 3 -1 3 -1 3 -1 3 -1 401 -1 3 -1 3 -1 3 -1 3 -1 3 -1 3 -1 
-1
