20
20
4
4 -1 4 -1 3 -1 3 -1 105 -1 3 -1 3 -1 3 -1 3 -1 3 -1 3 -1 3 -1 401 -1 3 -1 3 -1 6 -1 3 -1 3 -1 3 -1 3 -1 
3 -1 3 -1 3 -1 3 -1 101 -1 103 -1 103 -1 103 -1 103 -1 108 -1 3 -1 3 -1 3 -1 3 -1 3 -1 6 -1 3 -1 3 -1 3 -1 3 -1 
5 -1 5 -1 5 -1 5 -1 5 -1 5 -1 10 -1 3 -1 3 -1 105 -1 2 -1 2 -1 3 -1 3 -1 3 -1 6 -1 3 -1 3 -1 3 -1 3 -1 
3 -1 4 -1 401 3 3 -1 3 -1 3 -1 6 -1 2 -1 2 -1 105 -1 2 -1 2 -1 2 -1 2 -1 2 -1 6 -1 3 -1 3 -1 3 -1 3 -1 
3 -1 4 -1 401 3 3 -1 3 -1 3 -1 6 -1 2 -1 3 -1 105 -1 4 -1 4 -1 2 -1 3 -1 3 -1 6 -1 2 -1 3 -1 3 -1 3 -1 
4 -1 4 -1 4 -1 3 -1 3 -1 400 3 11 -1 5 -1 5 -1 0 -1 5 -1 5 -1 5 -1 5 -1 5 -1 15 -1 5 -1 5 -1 5 -1 5 -1 
4 -1 4 -1 3 -1 3 -1 3 -1 3 -1 6 -1 3 -1 3 -1 105 -1 402 -1 4 -1 2 -1 2 -1 2 -1 6 -1 3 -1 3 -1 3 -1 3 -1 
4 -1 3 -1 3 -1 401 -1 3 -1 3 -1 6 -1 3 -1 2 -1 105 -1 2 -1 2 -1 2 -1 2 -1 2 -1 6 -1 3 -1 3 -1 3 -1 3 -1 
4 -1 3 -1 3 -1 3 -1 3 -1 3 -1 6 -1 3 -1 2 -1 105 -1 3 -1 3 -1 401 -1 2 -1 3 -1 6 -1 3 -1 3 -1 401 -1 3 -1 
203 -1 322 -1 300 -1 300 -1 305 -1 3 -1 6 -1 402 3 3 -1 105 -1 2 -1 3 -1 3 -1 3 -1 3 -1 6 -1 3 -1 3 -1 3 -1 3 -1 
205 -1 225 -1 200 -1 200 -1 319 -1 3 -1 6 -1 3 -1 3 -1 105 -1 401 2 3 -1 3 -1 400 2 402 2 6 -1 3 -1 3 -1 3 -1 401 2 
4 -1 202 -1 200 -1 200 -1 200 -1 103 -1 1 -1 103 -1 103 -1 106 -1 103 -1 103 -1 103 -1 102 -1 103 -1 1 -1 103 -1 103 -1 103 -1 103 -1 
4 -1 214 -1 316 -1 308 -1 323 -1 3 -1 6 -1 401 0 3 -1 3 -1 3 -1 3 -1 3 -1 105 -1 3 -1 6 -1 3 -1 3 -1 2 -1 3 -1 
4 -1 4 -1 3 -1 306 -1 307 -1 3 -1 11 -1 5 -1 16 -1 5 -1 5 -1 402 -1 19 -1 0 -1 5 -1 14 -1 2 -1 2 -1 2 -1 2 -1 
4 -1 3 -1 3 -1 400 0 3 -1 3 -1 6 -1 3 -1 3 -1 3 -1 401 -1 3 -1 3 -1 101 -1 108 -1 6 -1 3 -1 2 -1 2 -1 2 -1 
4 -1 4 -1 3 -1 3 -1 3 -1 3 -1 18 -1 3 -1 3 -1 3 -1 3 -1 3 -1 3 -1 401 1 105 -1 6 -1 3 -1 402 1 2 -1 2 -1 
4 -1 4 -1 4 -1 3 -1 3 -1 402 0 17 -1 3 -1 109 -1 102 -1 103 -1 103 -1 102 -1 103 -1 106 -1 1 -1 103 -1 103 -1 103 -1 103 -1 
16 -1 5 -1 19 -1 16 -1 5 -1 19 -1 14 -1 3 -1 101 -1 100 -1 402 -1 401 1 105 -1 3 -1 400 1 6 -1 3 -1 401 -1 3 -1 3 -1 
4 -1 3 -1 3 -1 3 -1 3 -1 3 -1 7 -1 16 -1 19 -1 16 -1 5 -1 19 -1 0 -1 5 -1 5 -1 15 -1 5 -1 5 -1 5 -1 5 -1 
4 -1 4 -1 401 0 3 -1 3 -1 3 -1 3 -1 3 -1 3 -1 401 -1 3 -1 3 -1 105 -1 3 -1 3 -1 6 -1 3 -1 3 -1 3 -1 3 -1 
-1
